fips,FemaleCount,MaleCount,TotalCount,Years,ChiSquareStatistic,P-Value,Representation,FemaleRepresentation,FemaleRepresentationScore
1003,2,25,27,"[2000, 2000, 2000, 2000, 2000, 2000, 2000, 2004, 2004, 2004, 2004, 2006, 2006, 2006, 2006, 2010, 2010, 2010, 2010, 2014, 2014, 2014, 2014, 2018, 2018, 2018, 2018]",19.59259259259259,9.584005666471275e-06,Low Gender Representation,0.07407407407407407,1
1015,0,4,4,"[2018, 2018, 2018, 2018, 2018]",4.0,0.04550026389635857,Low Gender Representation,0.0,0
1055,0,8,8,"[2016, 2016, 2018, 2018, 2018, 2018, 2020, 2020]",8.0,0.004677734981047276,Low Gender Representation,0.0,0
1069,0,4,4,"[2018, 2018, 2018, 2018]",4.0,0.04550026389635857,Low Gender Representation,0.0,0
1073,9,20,29,"[2002, 2002, 2002, 2002, 2002, 2006, 2006, 2006, 2006, 2006, 2007, 2008, 2008, 2010, 2010, 2010, 2010, 2010, 2010, 2014, 2014, 2014, 2014, 2014, 2018, 2018, 2018, 2018, 2018]",4.172413793103448,0.04108722452782139,Low Gender Representation,0.3103448275862069,3
1081,1,6,7,"[2012, 2012, 2018, 2018, 2018, 2020, 2020]",3.5714285714285716,0.05878172135535891,Low Gender Representation not Detected,0.14285714285714285,1
1089,1,12,13,"[2016, 2016, 2016, 2016, 2016, 2016, 2020, 2020, 2020, 2020, 2020, 2020, 2020]",9.307692307692308,0.002281937253315446,Low Gender Representation,0.07692307692307693,1
1097,6,7,13,"[2004, 2004, 2004, 2008, 2008, 2008, 2010, 2016, 2016, 2016, 2020, 2020, 2020]",0.07692307692307693,0.7815112949987134,Low Gender Representation not Detected,0.46153846153846156,5
1101,2,14,16,"[2008, 2008, 2008, 2008, 2008, 2010, 2016, 2016, 2016, 2016, 2016, 2020, 2020, 2020, 2020, 2020]",9.0,0.0026997960632601883,Low Gender Representation,0.125,1
1103,1,21,22,"[2002, 2002, 2004, 2004, 2004, 2006, 2006, 2008, 2008, 2010, 2010, 2010, 2012, 2012, 2014, 2014, 2016, 2016, 2018, 2018, 2020, 2020]",18.181818181818183,2.007865612426481e-05,Low Gender Representation,0.045454545454545456,0
1117,2,16,18,"[2016, 2016, 2016, 2016, 2016, 2016, 2016, 2016, 2016, 2020, 2020, 2020, 2020, 2020, 2020, 2020, 2020, 2020]",10.88888888888889,0.0009674284502477464,Low Gender Representation,0.1111111111111111,1
1125,0,8,8,"[2016, 2016, 2016, 2016, 2020, 2020, 2020, 2020]",8.0,0.004677734981047276,Low Gender Representation,0.0,0
2020,1,4,5,"[2016, 2016, 2016, 2016, 2016]",1.8,0.17971249487899593,Low Gender Representation not Detected,0.2,2
4001,0,15,15,"[2004, 2004, 2004, 2008, 2008, 2008, 2012, 2012, 2012, 2016, 2016, 2016, 2020, 2020, 2020]",15.0,0.00010751117672950066,Low Gender Representation,0.0,0
4003,4,7,11,"[1992, 1992, 1992, 1996, 1996, 2016, 2016, 2016, 2020, 2020, 2020]",0.8181818181818182,0.36571229628151314,Low Gender Representation not Detected,0.36363636363636365,4
4005,12,9,21,"[1992, 1992, 2008, 2008, 2008, 2008, 2008, 2012, 2012, 2012, 2012, 2012, 2016, 2016, 2016, 2016, 2016, 2020, 2020, 2020, 2020, 2020]",0.42857142857142855,0.5126907602619235,Low Gender Representation not Detected,0.5714285714285714,6
4007,0,9,9,"[2012, 2012, 2012, 2016, 2016, 2016, 2020, 2020, 2020]",9.0,0.0026997960632601883,Low Gender Representation,0.0,0
4013,5,29,34,"[2000, 2000, 2000, 2000, 2000, 2004, 2004, 2004, 2004, 2004, 2008, 2008, 2008, 2008, 2008, 2012, 2012, 2012, 2012, 2012, 2013, 2014, 2014, 2016, 2016, 2016, 2016, 2016, 2020, 2020, 2020, 2020, 2020, 2021]",16.941176470588236,3.8556107156203535e-05,Low Gender Representation,0.14705882352941177,1
4015,6,13,19,"[2008, 2008, 2008, 2012, 2012, 2012, 2012, 2012, 2016, 2016, 2016, 2016, 2016, 2018, 2020, 2020, 2020, 2020, 2020]",2.5789473684210527,0.10829365589900916,Low Gender Representation not Detected,0.3157894736842105,3
4017,5,14,19,"[2008, 2008, 2008, 2008, 2012, 2012, 2012, 2012, 2012, 2016, 2016, 2016, 2016, 2016, 2020, 2020, 2020, 2020, 2020]",4.2631578947368425,0.03894745574202525,Low Gender Representation,0.2631578947368421,3
4019,13,21,34,"[1992, 1992, 1992, 1992, 1992, 2000, 2000, 2000, 2000, 2000, 2004, 2004, 2004, 2004, 2004, 2008, 2008, 2008, 2008, 2008, 2012, 2012, 2012, 2012, 2012, 2016, 2016, 2016, 2016, 2016, 2020, 2020, 2020, 2020, 2020]",1.8823529411764706,0.17006696145390077,Low Gender Representation not Detected,0.38235294117647056,4
4021,2,17,19,"[2000, 2000, 2000, 2008, 2008, 2008, 2012, 2012, 2012, 2016, 2016, 2016, 2016, 2016, 2020, 2020, 2020, 2020, 2020]",11.842105263157896,0.0005790632172192773,Low Gender Representation,0.10526315789473684,1
4025,4,13,17,"[2008, 2008, 2008, 2012, 2012, 2012, 2012, 2012, 2016, 2016, 2016, 2016, 2016, 2019, 2020, 2020, 2020, 2020, 2020]",4.764705882352941,0.029049022161940597,Low Gender Representation,0.23529411764705882,2
4027,2,13,15,"[2008, 2012, 2012, 2012, 2012, 2016, 2016, 2016, 2016, 2016, 2020, 2020, 2020, 2020, 2020]",8.066666666666666,0.004508698364904238,Low Gender Representation,0.13333333333333333,1
5007,7,5,12,"[1994, 1994, 1994, 1994, 1994, 1996, 1996, 2006, 2006, 2008, 2008, 2008]",0.3333333333333333,0.5637028616507731,Low Gender Representation not Detected,0.5833333333333334,6
5119,25,50,75,"[1990, 1990, 1990, 1990, 1990, 1990, 1992, 1992, 1992, 1992, 1992, 1992, 1994, 1994, 1994, 1994, 1994, 1994, 1994, 1996, 1996, 1996, 1996, 1996, 1996, 1996, 1996, 1996, 1996, 1996, 1996, 1998, 1998, 1998, 1998, 1998, 1998, 1998, 1998, 1998, 2000, 2000, 2000, 2002, 2002, 2002, 2004, 2004, 2004, 2006, 2006, 2008, 2008, 2008, 2010, 2010, 2010, 2010, 2010, 2010, 2010, 2012, 2012, 2012, 2012, 2012, 2012, 2012, 2012, 2014, 2014, 2014, 2014, 2014, 2014, 2014, 2014, 2016, 2016]",8.333333333333334,0.003892417122778637,Low Gender Representation,0.3333333333333333,3
5143,11,16,27,"[2008, 2008, 2008, 2010, 2010, 2010, 2010, 2012, 2012, 2012, 2012, 2012, 2012, 2012, 2012, 2012, 2014, 2014, 2014, 2014, 2014, 2014, 2016, 2016, 2016, 2016, 2016]",0.9259259259259259,0.3359238131517329,Low Gender Representation not Detected,0.4074074074074074,4
6001,13,28,41,"[1996, 1996, 1996, 1996, 1996, 1998, 1998, 2000, 2000, 2000, 2000, 2002, 2002, 2002, 2004, 2004, 2004, 2006, 2006, 2008, 2008, 2008, 2010, 2010, 2010, 2012, 2012, 2012, 2012, 2014, 2014, 2016, 2016, 2016, 2018, 2018, 2020, 2020, 2020, 2020, 2021]",5.487804878048781,0.019149571500766092,Low Gender Representation,0.3170731707317073,3
6007,17,22,39,"[1996, 1996, 1996, 1996, 1996, 1996, 1996, 1996, 1998, 1998, 2000, 2000, 2000, 2000, 2000, 2002, 2002, 2004, 2004, 2004, 2006, 2006, 2006, 2008, 2008, 2008, 2010, 2010, 2012, 2012, 2012, 2012, 2014, 2014, 2016, 2016, 2016, 2018, 2018, 2020, 2020, 2020]",0.6410256410256411,0.4233396415824435,Low Gender Representation not Detected,0.4358974358974359,4
6013,20,22,42,"[1996, 1996, 1996, 1996, 1996, 1998, 1998, 2000, 2000, 2000, 2000, 2000, 2002, 2002, 2004, 2004, 2004, 2004, 2006, 2006, 2008, 2008, 2008, 2008, 2010, 2010, 2012, 2012, 2012, 2014, 2014, 2016, 2016, 2016, 2016, 2016, 2018, 2018, 2020, 2020, 2020, 2020]",0.09523809523809523,0.7576207236833966,Low Gender Representation not Detected,0.47619047619047616,5
6017,18,32,50,"[1996, 1996, 1996, 1996, 1998, 1998, 2000, 2000, 2000, 2000, 2000, 2002, 2002, 2002, 2003, 2004, 2004, 2004, 2005, 2006, 2006, 2006, 2008, 2008, 2008, 2008, 2008, 2010, 2010, 2012, 2012, 2012, 2012, 2014, 2014, 2014, 2014, 2014, 2016, 2016, 2016, 2016, 2018, 2018, 2018, 2018, 2020, 2020, 2020, 2020, 2020]",3.92,0.04771488023735101,Low Gender Representation,0.36,4
6019,12,30,42,"[1996, 1996, 1996, 1996, 1998, 1998, 1998, 2000, 2000, 2000, 2000, 2002, 2002, 2002, 2004, 2004, 2004, 2004, 2006, 2006, 2008, 2008, 2008, 2010, 2010, 2010, 2012, 2012, 2012, 2014, 2014, 2014, 2014, 2016, 2016, 2016, 2018, 2018, 2019, 2020, 2020, 2020]",7.714285714285714,0.00547855324254737,Low Gender Representation,0.2857142857142857,3
6023,12,32,44,"[1996, 1996, 1996, 1996, 1998, 1998, 1998, 1998, 2000, 2000, 2000, 2000, 2002, 2002, 2002, 2004, 2004, 2004, 2006, 2006, 2006, 2008, 2008, 2008, 2008, 2010, 2010, 2010, 2010, 2010, 2012, 2012, 2012, 2014, 2014, 2016, 2016, 2016, 2018, 2018, 2020, 2020, 2020, 2020]",9.090909090909092,0.0025688315270227116,Low Gender Representation,0.2727272727272727,3
6025,4,41,45,"[1996, 1996, 1996, 1998, 1998, 1998, 2000, 2000, 2000, 2000, 2000, 2000, 2002, 2002, 2004, 2004, 2004, 2006, 2006, 2006, 2008, 2008, 2008, 2008, 2010, 2010, 2010, 2010, 2012, 2012, 2012, 2014, 2014, 2014, 2014, 2016, 2016, 2016, 2016, 2018, 2018, 2018, 2020, 2020, 2020]",30.42222222222222,3.475241498463514e-08,Low Gender Representation,0.08888888888888889,1
6029,7,34,41,"[1996, 1996, 1996, 1996, 1996, 1998, 1998, 2000, 2000, 2000, 2000, 2002, 2002, 2002, 2002, 2004, 2004, 2004, 2006, 2006, 2008, 2008, 2008, 2010, 2010, 2010, 2012, 2012, 2012, 2012, 2014, 2014, 2016, 2016, 2016, 2018, 2018, 2018, 2020, 2020, 2020]",17.78048780487805,2.4791268594989224e-05,Low Gender Representation,0.17073170731707318,2
6031,5,32,37,"[1996, 1996, 1996, 1998, 1998, 1998, 2000, 2000, 2000, 2002, 2002, 2002, 2002, 2004, 2004, 2006, 2008, 2008, 2008, 2008, 2010, 2010, 2010, 2012, 2012, 2012, 2014, 2014, 2014, 2014, 2016, 2016, 2018, 2018, 2018, 2020, 2020]",19.7027027027027,9.047331907067938e-06,Low Gender Representation,0.13513513513513514,1
6033,9,34,43,"[1996, 1996, 1996, 1996, 1998, 1998, 1998, 1998, 2000, 2000, 2000, 2000, 2002, 2002, 2004, 2004, 2004, 2004, 2006, 2006, 2006, 2008, 2008, 2008, 2008, 2010, 2010, 2012, 2012, 2012, 2014, 2014, 2014, 2014, 2016, 2016, 2016, 2016, 2016, 2018, 2018, 2020, 2020, 2020, 2020]",14.534883720930232,0.000137588130325423,Low Gender Representation,0.20930232558139536,2
6037,20,24,44,"[1990, 1991, 1992, 1992, 1992, 1994, 1994, 1996, 1996, 1996, 1996, 1998, 1998, 2000, 2000, 2000, 2002, 2002, 2004, 2004, 2004, 2006, 2006, 2008, 2008, 2008, 2008, 2010, 2010, 2012, 2012, 2012, 2014, 2014, 2014, 2016, 2016, 2016, 2016, 2016, 2018, 2018, 2020, 2020, 2020, 2020]",0.36363636363636365,0.5464935954065822,Low Gender Representation not Detected,0.45454545454545453,5
6039,6,33,39,"[1996, 1996, 1996, 1996, 1998, 1998, 1998, 1998, 1998, 2000, 2000, 2000, 2002, 2002, 2002, 2004, 2004, 2004, 2006, 2006, 2006, 2006, 2008, 2008, 2010, 2010, 2010, 2010, 2012, 2012, 2012, 2014, 2014, 2014, 2016, 2016, 2018, 2018, 2018, 2020, 2020]",18.692307692307693,1.5360089173081908e-05,Low Gender Representation,0.15384615384615385,2
6041,21,19,40,"[1996, 1996, 1996, 1996, 1998, 1998, 1998, 2000, 2000, 2000, 2002, 2002, 2002, 2004, 2004, 2004, 2004, 2006, 2006, 2006, 2008, 2008, 2008, 2010, 2010, 2011, 2012, 2012, 2012, 2014, 2014, 2016, 2016, 2016, 2016, 2018, 2018, 2020, 2020, 2020]",0.1,0.7518296340458492,Low Gender Representation not Detected,0.525,5
6045,13,35,48,"[1996, 1996, 1996, 1996, 1998, 1998, 1998, 2000, 2000, 2000, 2002, 2002, 2002, 2004, 2004, 2004, 2004, 2004, 2006, 2006, 2008, 2008, 2008, 2008, 2008, 2010, 2010, 2010, 2010, 2012, 2012, 2012, 2014, 2014, 2014, 2014, 2016, 2016, 2016, 2018, 2018, 2018, 2018, 2018, 2018, 2020, 2020, 2020, 2020, 2020]",10.083333333333334,0.0014961642897455517,Low Gender Representation,0.2708333333333333,3
6047,14,26,40,"[1996, 1996, 1996, 1998, 1998, 2000, 2000, 2000, 2002, 2002, 2002, 2004, 2004, 2004, 2004, 2006, 2006, 2008, 2008, 2008, 2008, 2010, 2010, 2012, 2012, 2012, 2012, 2014, 2014, 2014, 2016, 2016, 2016, 2016, 2016, 2018, 2018, 2020, 2020, 2020, 2020]",3.6,0.05777957112359715,Low Gender Representation not Detected,0.35,4
6053,11,28,39,"[1996, 1996, 1996, 1996, 1998, 1998, 1998, 2000, 2000, 2000, 2002, 2002, 2004, 2004, 2004, 2004, 2006, 2006, 2008, 2008, 2008, 2010, 2010, 2012, 2012, 2012, 2012, 2012, 2014, 2014, 2014, 2016, 2016, 2016, 2018, 2018, 2020, 2020, 2020, 2020]",7.410256410256411,0.00648530797067137,Low Gender Representation,0.28205128205128205,3
6055,10,30,40,"[1996, 1996, 1996, 1998, 1998, 1998, 2000, 2000, 2000, 2002, 2002, 2002, 2004, 2004, 2004, 2006, 2006, 2008, 2008, 2008, 2008, 2008, 2010, 2010, 2010, 2012, 2012, 2012, 2012, 2014, 2014, 2016, 2016, 2016, 2016, 2018, 2018, 2020, 2020, 2020]",10.0,0.001565402258002549,Low Gender Representation,0.25,2
6057,8,32,40,"[1996, 1996, 1996, 1998, 1998, 1998, 2000, 2000, 2000, 2000, 2000, 2002, 2002, 2002, 2002, 2004, 2004, 2004, 2004, 2004, 2006, 2006, 2008, 2008, 2008, 2008, 2010, 2010, 2012, 2012, 2012, 2014, 2014, 2016, 2016, 2016, 2018, 2018, 2020, 2020, 2020]",14.4,0.00014780231033445398,Low Gender Representation,0.2,2
6059,14,34,48,"[1996, 1996, 1996, 1996, 1998, 1998, 1998, 1998, 1998, 2000, 2000, 2002, 2002, 2002, 2003, 2004, 2004, 2006, 2006, 2006, 2006, 2007, 2008, 2008, 2010, 2010, 2010, 2010, 2012, 2012, 2014, 2014, 2014, 2014, 2014, 2015, 2016, 2016, 2016, 2018, 2018, 2018, 2018, 2019, 2020, 2020, 2020, 2021]",8.333333333333334,0.003892417122778637,Low Gender Representation,0.2916666666666667,3
6061,8,30,38,"[1996, 1996, 1996, 1996, 1998, 1998, 1998, 1998, 2000, 2000, 2000, 2002, 2002, 2004, 2004, 2004, 2004, 2006, 2006, 2006, 2008, 2008, 2008, 2008, 2010, 2010, 2012, 2012, 2012, 2014, 2014, 2016, 2016, 2016, 2018, 2018, 2020, 2020, 2020]",12.736842105263158,0.00035852252875322714,Low Gender Representation,0.21052631578947367,2
6065,2,39,41,"[1996, 1996, 1996, 1998, 1998, 1998, 2000, 2000, 2002, 2002, 2002, 2002, 2004, 2004, 2006, 2006, 2006, 2008, 2008, 2009, 2010, 2010, 2010, 2012, 2012, 2012, 2014, 2014, 2014, 2015, 2016, 2016, 2016, 2017, 2018, 2018, 2018, 2018, 2018, 2020, 2020]",33.390243902439025,7.540126507241664e-09,Low Gender Representation,0.04878048780487805,0
6067,16,20,36,"[1996, 1996, 1998, 1998, 1998, 1999, 2000, 2000, 2002, 2002, 2002, 2004, 2004, 2004, 2006, 2006, 2006, 2008, 2008, 2010, 2010, 2010, 2012, 2012, 2014, 2014, 2014, 2016, 2016, 2016, 2018, 2018, 2018, 2020, 2020, 2020]",0.4444444444444444,0.5049850750938457,Low Gender Representation not Detected,0.4444444444444444,4
6069,8,38,46,"[1996, 1996, 1996, 1996, 1996, 1998, 1998, 1998, 2000, 2000, 2000, 2000, 2002, 2002, 2002, 2004, 2004, 2004, 2004, 2006, 2006, 2006, 2008, 2008, 2008, 2010, 2010, 2010, 2012, 2012, 2012, 2014, 2014, 2014, 2016, 2016, 2016, 2018, 2018, 2018, 2018, 2020, 2020, 2020, 2020, 2020]",19.565217391304348,9.722321453020404e-06,Low Gender Representation,0.17391304347826086,2
6071,11,34,45,"[1996, 1996, 1996, 1996, 1996, 1998, 1998, 2000, 2000, 2000, 2000, 2000, 2002, 2002, 2002, 2004, 2004, 2004, 2004, 2004, 2006, 2006, 2008, 2008, 2008, 2010, 2010, 2010, 2012, 2012, 2012, 2012, 2012, 2014, 2014, 2016, 2016, 2016, 2016, 2018, 2018, 2020, 2020, 2020, 2020]",11.755555555555556,0.0006066190209832519,Low Gender Representation,0.24444444444444444,2
6073,21,31,52,"[1990, 1990, 1992, 1992, 1992, 1994, 1994, 1996, 1996, 1996, 1998, 1998, 2000, 2000, 2000, 2002, 2002, 2004, 2004, 2004, 2006, 2006, 2008, 2008, 2008, 2010, 2010, 2010, 2010, 2010, 2010, 2012, 2012, 2012, 2012, 2014, 2014, 2016, 2016, 2016, 2016, 2018, 2018, 2018, 2018, 2018, 2018, 2020, 2020, 2020, 2020, 2020, 2020]",1.9230769230769231,0.16551785869746605,Low Gender Representation not Detected,0.40384615384615385,4
6075,24,50,74,"[2000, 2000, 2000, 2000, 2000, 2000, 2000, 2000, 2000, 2000, 2000, 2002, 2002, 2002, 2002, 2002, 2002, 2002, 2004, 2004, 2004, 2004, 2004, 2004, 2004, 2006, 2006, 2006, 2006, 2006, 2008, 2008, 2008, 2008, 2008, 2008, 2008, 2010, 2010, 2010, 2010, 2010, 2012, 2012, 2012, 2012, 2012, 2012, 2013, 2014, 2014, 2014, 2014, 2014, 2015, 2016, 2016, 2016, 2016, 2016, 2016, 2018, 2018, 2018, 2018, 2018, 2018, 2019, 2020, 2020, 2020, 2020, 2020, 2020]",9.135135135135135,0.0025074693935343085,Low Gender Representation,0.32432432432432434,3
6077,4,37,41,"[1996, 1996, 1996, 1996, 1998, 1998, 1998, 2000, 2000, 2002, 2002, 2002, 2002, 2004, 2004, 2004, 2006, 2006, 2006, 2008, 2008, 2008, 2008, 2010, 2010, 2012, 2012, 2012, 2012, 2014, 2014, 2016, 2016, 2016, 2016, 2016, 2018, 2018, 2020, 2020, 2020, 2020]",26.5609756097561,2.5534989161461907e-07,Low Gender Representation,0.0975609756097561,1
6079,11,28,39,"[1996, 1996, 1996, 1996, 1996, 1998, 1998, 1998, 1998, 2000, 2000, 2000, 2002, 2002, 2004, 2004, 2004, 2004, 2006, 2006, 2006, 2008, 2008, 2008, 2010, 2010, 2010, 2012, 2012, 2012, 2014, 2014, 2014, 2016, 2016, 2016, 2016, 2016, 2018, 2018, 2020, 2020, 2020]",7.410256410256411,0.00648530797067137,Low Gender Representation,0.28205128205128205,3
6081,11,27,38,"[1996, 1996, 1996, 1997, 1998, 1998, 2000, 2000, 2000, 2002, 2002, 2004, 2004, 2004, 2006, 2006, 2008, 2008, 2008, 2010, 2010, 2010, 2011, 2012, 2012, 2012, 2012, 2014, 2014, 2016, 2016, 2016, 2016, 2018, 2018, 2020, 2020, 2020]",6.7368421052631575,0.009444165687832655,Low Gender Representation,0.2894736842105263,3
6083,20,20,40,"[1996, 1996, 1996, 1996, 1998, 1998, 1998, 1998, 2000, 2000, 2000, 2002, 2002, 2002, 2004, 2004, 2004, 2006, 2006, 2006, 2008, 2008, 2008, 2008, 2010, 2010, 2012, 2012, 2012, 2012, 2014, 2014, 2016, 2016, 2016, 2016, 2018, 2018, 2020, 2020, 2020]",0.0,1.0,Low Gender Representation not Detected,0.5,5
6085,14,37,51,"[1990, 1990, 1992, 1992, 1992, 1994, 1994, 1996, 1996, 1996, 1996, 1996, 1997, 1997, 1998, 1998, 2000, 2000, 2000, 2000, 2002, 2002, 2004, 2004, 2004, 2006, 2006, 2008, 2008, 2008, 2008, 2008, 2010, 2010, 2010, 2012, 2012, 2012, 2013, 2013, 2014, 2014, 2016, 2016, 2016, 2018, 2018, 2018, 2020, 2020, 2020, 2020]",10.372549019607844,0.0012790283276835727,Low Gender Representation,0.27450980392156865,3
6087,10,31,41,"[1996, 1996, 1996, 1996, 1998, 1998, 2000, 2000, 2000, 2000, 2002, 2002, 2002, 2004, 2004, 2004, 2004, 2006, 2006, 2008, 2008, 2008, 2010, 2010, 2010, 2012, 2012, 2012, 2012, 2014, 2014, 2014, 2016, 2016, 2016, 2018, 2018, 2018, 2020, 2020, 2020, 2020]",10.75609756097561,0.001039363099133526,Low Gender Representation,0.24390243902439024,2
6089,14,28,42,"[1996, 1996, 1996, 1998, 1998, 2000, 2000, 2000, 2002, 2002, 2004, 2004, 2004, 2004, 2004, 2006, 2006, 2006, 2008, 2008, 2008, 2010, 2010, 2010, 2012, 2012, 2012, 2012, 2014, 2014, 2016, 2016, 2016, 2016, 2016, 2018, 2018, 2018, 2020, 2020, 2020, 2020]",4.666666666666667,0.03075356125927451,Low Gender Representation,0.3333333333333333,3
6095,12,25,37,"[1996, 1998, 1998, 2000, 2000, 2000, 2002, 2002, 2002, 2004, 2004, 2004, 2006, 2006, 2008, 2008, 2008, 2008, 2010, 2010, 2010, 2012, 2012, 2012, 2012, 2014, 2014, 2014, 2016, 2016, 2016, 2016, 2018, 2018, 2020, 2020, 2020]",4.5675675675675675,0.03258279838561265,Low Gender Representation,0.32432432432432434,3
6097,14,29,43,"[1996, 1996, 1996, 1996, 1998, 1998, 1998, 2000, 2000, 2000, 2002, 2002, 2002, 2004, 2004, 2004, 2006, 2006, 2008, 2008, 2008, 2008, 2008, 2008, 2010, 2010, 2010, 2012, 2012, 2012, 2012, 2014, 2014, 2014, 2016, 2016, 2016, 2016, 2018, 2018, 2020, 2020, 2020]",5.232558139534884,0.022167905752988753,Low Gender Representation,0.32558139534883723,3
6099,4,36,40,"[1996, 1996, 1996, 1998, 1998, 2000, 2000, 2000, 2002, 2002, 2004, 2004, 2004, 2004, 2006, 2006, 2006, 2006, 2008, 2008, 2008, 2010, 2010, 2012, 2012, 2012, 2014, 2014, 2016, 2016, 2016, 2018, 2018, 2018, 2018, 2020, 2020, 2020, 2020, 2020]",25.6,4.200393976022008e-07,Low Gender Representation,0.1,1
6101,4,33,37,"[1996, 1998, 1998, 2000, 2000, 2000, 2002, 2002, 2002, 2004, 2004, 2004, 2004, 2006, 2006, 2006, 2010, 2010, 2012, 2012, 2012, 2012, 2014, 2014, 2016, 2016, 2016, 2016, 2016, 2018, 2018, 2018, 2020, 2020, 2020, 2020, 2020]",22.72972972972973,1.864606348180602e-06,Low Gender Representation,0.10810810810810811,1
6103,5,28,33,"[1996, 1996, 1996, 1996, 1998, 1998, 2002, 2002, 2004, 2004, 2004, 2006, 2006, 2008, 2008, 2008, 2008, 2008, 2010, 2010, 2012, 2012, 2012, 2014, 2014, 2014, 2014, 2016, 2016, 2016, 2018, 2018, 2020, 2020, 2020, 2020]",16.03030303030303,6.233673525160706e-05,Low Gender Representation,0.15151515151515152,2
6107,6,36,42,"[1996, 1996, 1996, 1998, 1998, 1998, 2000, 2000, 2000, 2000, 2002, 2002, 2004, 2004, 2004, 2004, 2004, 2006, 2006, 2006, 2008, 2008, 2008, 2010, 2010, 2010, 2012, 2012, 2012, 2014, 2014, 2014, 2016, 2016, 2016, 2016, 2018, 2018, 2020, 2020, 2020, 2020]",21.428571428571427,3.6725751142656362e-06,Low Gender Representation,0.14285714285714285,1
6109,8,38,46,"[1996, 1996, 1996, 1996, 1996, 1998, 1998, 1998, 2000, 2000, 2000, 2002, 2002, 2002, 2002, 2004, 2004, 2004, 2004, 2006, 2006, 2006, 2008, 2008, 2008, 2008, 2010, 2010, 2012, 2012, 2012, 2012, 2012, 2014, 2014, 2016, 2016, 2016, 2018, 2018, 2018, 2018, 2020, 2020, 2020, 2020, 2020]",19.565217391304348,9.722321453020404e-06,Low Gender Representation,0.17391304347826086,2
6111,19,20,39,"[1996, 1998, 1998, 2000, 2000, 2000, 2000, 2000, 2002, 2002, 2004, 2004, 2004, 2004, 2006, 2006, 2006, 2008, 2008, 2008, 2008, 2010, 2010, 2012, 2012, 2012, 2012, 2014, 2014, 2016, 2016, 2016, 2016, 2018, 2018, 2020, 2020, 2020, 2020]",0.02564102564102564,0.8727801237939118,Low Gender Representation not Detected,0.48717948717948717,5
6113,7,30,37,"[1996, 1996, 1996, 1998, 1998, 2000, 2000, 2000, 2002, 2002, 2004, 2004, 2004, 2004, 2006, 2006, 2006, 2008, 2008, 2008, 2010, 2010, 2012, 2012, 2012, 2014, 2014, 2014, 2016, 2016, 2016, 2018, 2018, 2020, 2020, 2020, 2020]",14.297297297297296,0.0001560888275095426,Low Gender Representation,0.1891891891891892,2
6115,6,35,41,"[1996, 1996, 1996, 1996, 1998, 1998, 2000, 2000, 2000, 2002, 2002, 2004, 2004, 2004, 2004, 2006, 2006, 2008, 2008, 2008, 2010, 2010, 2010, 2012, 2012, 2012, 2014, 2014, 2014, 2016, 2016, 2016, 2016, 2018, 2018, 2018, 2018, 2020, 2020, 2020, 2020]",20.51219512195122,5.9252535998199065e-06,Low Gender Representation,0.14634146341463414,1
8001,12,17,29,"[1990, 1992, 1992, 1994, 1996, 1996, 1998, 2000, 2000, 2002, 2004, 2004, 2006, 2008, 2008, 2010, 2012, 2012, 2014, 2014, 2014, 2016, 2016, 2016, 2018, 2018, 2020, 2020, 2020]",0.8620689655172413,0.35316035331598783,Low Gender Representation not Detected,0.41379310344827586,4
8005,23,15,38,"[1990, 1992, 1994, 1996, 1996, 1996, 1998, 1998, 1999, 2000, 2000, 2000, 2000, 2002, 2002, 2004, 2004, 2004, 2006, 2006, 2008, 2008, 2008, 2010, 2010, 2012, 2012, 2012, 2014, 2014, 2016, 2016, 2016, 2018, 2018, 2020, 2020, 2020]",1.6842105263157894,0.19436591080310542,Low Gender Representation not Detected,0.6052631578947368,6
8013,13,11,24,"[1990, 1994, 1996, 1996, 1998, 2000, 2000, 2002, 2004, 2004, 2006, 2007, 2008, 2008, 2008, 2010, 2012, 2012, 2014, 2016, 2016, 2018, 2020, 2020]",0.16666666666666666,0.6830913983096086,Low Gender Representation not Detected,0.5416666666666666,5
8031,13,13,26,"[2015, 2015, 2015, 2015, 2015, 2015, 2015, 2015, 2015, 2015, 2015, 2015, 2015, 2019, 2019, 2019, 2019, 2019, 2019, 2019, 2019, 2019, 2019, 2019, 2019, 2019]",0.0,1.0,Low Gender Representation not Detected,0.5,5
8035,7,18,25,"[1990, 1992, 1992, 1994, 1996, 1996, 1998, 2000, 2000, 2002, 2004, 2004, 2006, 2008, 2008, 2010, 2012, 2012, 2014, 2016, 2016, 2018, 2018, 2020, 2020]",4.84,0.027806895026997264,Low Gender Representation,0.28,3
8037,8,7,15,"[2004, 2004, 2006, 2008, 2008, 2010, 2012, 2012, 2014, 2016, 2016, 2018, 2019, 2020, 2020]",0.06666666666666667,0.7962534147376392,Low Gender Representation not Detected,0.5333333333333333,5
8041,13,20,33,"[1996, 1996, 1996, 1998, 1998, 2000, 2000, 2000, 2002, 2002, 2004, 2004, 2004, 2006, 2006, 2008, 2008, 2008, 2010, 2010, 2012, 2012, 2012, 2014, 2014, 2016, 2016, 2016, 2018, 2018, 2020, 2020, 2020]",1.4848484848484849,0.22301746994661142,Low Gender Representation not Detected,0.3939393939393939,4
8045,0,13,13,"[2004, 2004, 2006, 2008, 2008, 2010, 2012, 2012, 2014, 2016, 2016, 2018, 2020, 2020]",13.0,0.0003114909767673841,Low Gender Representation,0.0,0
8059,10,16,26,"[1990, 1992, 1992, 1994, 1996, 1996, 1998, 2000, 2000, 2002, 2004, 2004, 2005, 2006, 2008, 2008, 2010, 2011, 2012, 2012, 2014, 2016, 2016, 2018, 2020, 2020]",1.3846153846153846,0.23931654122149193,Low Gender Representation not Detected,0.38461538461538464,4
8067,7,7,14,"[2004, 2004, 2006, 2008, 2008, 2010, 2012, 2012, 2014, 2016, 2016, 2018, 2020, 2020]",0.0,1.0,Low Gender Representation not Detected,0.5,5
8069,5,12,17,"[2000, 2000, 2002, 2004, 2004, 2006, 2008, 2008, 2010, 2012, 2012, 2014, 2016, 2016, 2018, 2020, 2020]",2.8823529411764706,0.08955507441364248,Low Gender Representation not Detected,0.29411764705882354,3
8077,10,14,24,"[1990, 1992, 1992, 1994, 1996, 1996, 1998, 2000, 2000, 2002, 2004, 2004, 2006, 2008, 2008, 2010, 2012, 2012, 2014, 2016, 2016, 2018, 2020, 2020]",0.6666666666666666,0.4142161782425251,Low Gender Representation not Detected,0.4166666666666667,4
8101,3,14,17,"[2000, 2000, 2002, 2004, 2004, 2006, 2008, 2008, 2010, 2012, 2012, 2014, 2016, 2016, 2018, 2020, 2020]",7.117647058823529,0.007632881787792295,Low Gender Representation,0.17647058823529413,2
8123,15,39,54,"[1990, 1990, 1992, 1992, 1992, 1994, 1994, 1996, 1996, 1996, 2000, 2000, 2000, 2000, 2000, 2002, 2002, 2002, 2002, 2004, 2004, 2004, 2004, 2004, 2006, 2006, 2008, 2008, 2008, 2008, 2008, 2008, 2010, 2010, 2010, 2010, 2012, 2012, 2012, 2012, 2012, 2012, 2014, 2014, 2014, 2016, 2016, 2016, 2016, 2018, 2018, 2018, 2018, 2020, 2020]",10.666666666666666,0.0010908351761252995,Low Gender Representation,0.2777777777777778,3
10001,1,56,57,"[1990, 1990, 1990, 1990, 1992, 1992, 1992, 1994, 1994, 1994, 1994, 1996, 1996, 1996, 1998, 1998, 1998, 1998, 2000, 2000, 2000, 2002, 2002, 2002, 2002, 2004, 2004, 2004, 2006, 2006, 2006, 2006, 2007, 2008, 2008, 2008, 2010, 2010, 2010, 2010, 2012, 2012, 2012, 2014, 2014, 2014, 2014, 2016, 2016, 2016, 2018, 2018, 2018, 2018, 2020, 2020, 2020]",53.07017543859649,3.2184222607961463e-13,Low Gender Representation,0.017543859649122806,0
10003,16,70,86,"[1990, 1990, 1990, 1992, 1992, 1992, 1992, 1992, 1992, 1994, 1994, 1994, 1996, 1996, 1998, 1998, 2000, 2002, 2002, 2002, 2002, 2002, 2002, 2004, 2004, 2004, 2004, 2004, 2004, 2004, 2004, 2006, 2006, 2006, 2006, 2006, 2006, 2008, 2008, 2008, 2008, 2008, 2008, 2008, 2009, 2010, 2010, 2010, 2010, 2010, 2010, 2011, 2012, 2012, 2012, 2012, 2012, 2012, 2012, 2014, 2014, 2014, 2014, 2014, 2014, 2016, 2016, 2016, 2016, 2016, 2016, 2016, 2016, 2018, 2018, 2018, 2018, 2018, 2018, 2020, 2020, 2020, 2020, 2020, 2020, 2020]",33.906976744186046,5.78110212493468e-09,Low Gender Representation,0.18604651162790697,2
10005,3,29,32,"[1994, 1994, 1998, 1998, 2000, 2000, 2000, 2002, 2002, 2004, 2004, 2004, 2006, 2006, 2008, 2008, 2008, 2010, 2010, 2012, 2012, 2012, 2014, 2014, 2016, 2016, 2016, 2018, 2018, 2020, 2020, 2020]",21.125,4.302779463675118e-06,Low Gender Representation,0.09375,1
12001,14,16,30,"[1990, 1992, 1992, 1994, 1996, 2000, 2000, 2000, 2002, 2002, 2004, 2004, 2004, 2006, 2006, 2008, 2008, 2008, 2010, 2010, 2012, 2012, 2012, 2014, 2014, 2016, 2016, 2018, 2020, 2020]",0.13333333333333333,0.7150006546880892,Low Gender Representation not Detected,0.4666666666666667,5
12005,0,17,17,"[1998, 2000, 2000, 2000, 2002, 2002, 2004, 2004, 2004, 2006, 2008, 2008, 2010, 2012, 2012, 2016, 2020]",17.0,3.737981840170153e-05,Low Gender Representation,0.0,0
12009,15,12,27,"[2000, 2000, 2000, 2002, 2004, 2004, 2004, 2006, 2006, 2008, 2008, 2008, 2010, 2010, 2012, 2012, 2012, 2014, 2014, 2016, 2016, 2016, 2018, 2018, 2020, 2020, 2020]",0.3333333333333333,0.5637028616507731,Low Gender Representation not Detected,0.5555555555555556,6
12011,35,30,65,"[1992, 1992, 1992, 1994, 1996, 1996, 1996, 1998, 1998, 2000, 2000, 2000, 2000, 2000, 2000, 2002, 2002, 2002, 2002, 2003, 2004, 2004, 2004, 2004, 2004, 2006, 2006, 2006, 2006, 2006, 2008, 2008, 2008, 2008, 2008, 2009, 2010, 2010, 2010, 2010, 2010, 2010, 2012, 2012, 2012, 2012, 2012, 2014, 2014, 2014, 2014, 2016, 2016, 2016, 2016, 2016, 2018, 2018, 2018, 2018, 2020, 2020, 2020, 2020, 2020]",0.38461538461538464,0.5351434523977505,Low Gender Representation not Detected,0.5384615384615384,5
12015,3,14,17,"[2000, 2000, 2002, 2004, 2004, 2004, 2006, 2008, 2008, 2008, 2010, 2012, 2012, 2012, 2014, 2016, 2018]",7.117647058823529,0.007632881787792295,Low Gender Representation,0.17647058823529413,2
12017,1,11,12,"[2006, 2006, 2008, 2008, 2008, 2010, 2010, 2016, 2016, 2016, 2018, 2018]",8.333333333333334,0.003892417122778637,Low Gender Representation,0.08333333333333333,1
12019,1,13,14,"[1990, 1992, 1994, 1996, 2000, 2006, 2006, 2008, 2008, 2010, 2012, 2014, 2016, 2018]",10.285714285714286,0.0013406411172294807,Low Gender Representation,0.07142857142857142,1
12021,8,19,27,"[1990, 1990, 1992, 1992, 1992, 1994, 1994, 1996, 1996, 1998, 1998, 1998, 2000, 2000, 2000, 2002, 2004, 2006, 2008, 2010, 2012, 2012, 2016, 2016, 2018, 2020, 2020]",4.481481481481482,0.034264007734869095,Low Gender Representation,0.2962962962962963,3
12031,1,3,4,"[2019, 2019, 2019, 2019]",1.0,0.31731050786291115,Low Gender Representation not Detected,0.25,2
12033,1,15,16,"[1990, 2006, 2008, 2008, 2008, 2010, 2010, 2012, 2012, 2012, 2014, 2014, 2016, 2016, 2018, 2020]",12.25,0.0004652581580710503,Low Gender Representation,0.0625,1
12053,2,14,16,"[2008, 2008, 2008, 2010, 2012, 2012, 2012, 2014, 2014, 2016, 2016, 2016, 2018, 2018, 2020, 2020]",9.0,0.0026997960632601883,Low Gender Representation,0.125,1
12057,28,38,66,"[1990, 1990, 1990, 1990, 1992, 1992, 1992, 1992, 1992, 1994, 1994, 1994, 1994, 1994, 1996, 1996, 1996, 1998, 1998, 1998, 1998, 2000, 2000, 2000, 2002, 2002, 2002, 2002, 2002, 2002, 2004, 2004, 2004, 2004, 2006, 2006, 2006, 2006, 2006, 2008, 2008, 2008, 2010, 2010, 2010, 2010, 2010, 2012, 2012, 2012, 2012, 2012, 2014, 2014, 2014, 2014, 2016, 2016, 2016, 2018, 2018, 2018, 2018, 2020, 2020, 2020]",1.5151515151515151,0.21835469056589815,Low Gender Representation not Detected,0.42424242424242425,4
12061,1,11,12,"[2002, 2004, 2004, 2006, 2006, 2008, 2008, 2010, 2010, 2012, 2014, 2016]",8.333333333333334,0.003892417122778637,Low Gender Representation,0.08333333333333333,1
12069,9,7,16,"[1994, 1994, 1996, 1998, 2002, 2002, 2004, 2006, 2006, 2008, 2010, 2010, 2012, 2014, 2016, 2016]",0.25,0.6170750774519739,Low Gender Representation not Detected,0.5625,6
12071,2,30,32,"[1990, 1992, 1992, 1992, 1996, 1996, 1996, 1998, 1998, 2000, 2000, 2000, 2002, 2002, 2004, 2004, 2004, 2004, 2006, 2006, 2006, 2008, 2008, 2008, 2016, 2016, 2016, 2018, 2018, 2019, 2020, 2020, 2020]",24.5,7.430983723414125e-07,Low Gender Representation,0.0625,1
12073,5,12,17,"[2000, 2000, 2000, 2006, 2006, 2008, 2010, 2010, 2012, 2012, 2014, 2014, 2016, 2016, 2018, 2020, 2020]",2.8823529411764706,0.08955507441364248,Low Gender Representation not Detected,0.29411764705882354,3
12081,10,7,17,"[2008, 2010, 2010, 2012, 2012, 2012, 2014, 2014, 2016, 2016, 2018, 2018, 2018, 2020, 2020, 2020, 2020]",0.5294117647058824,0.46685427082272524,Low Gender Representation not Detected,0.5882352941176471,6
12083,3,11,14,"[2006, 2006, 2008, 2008, 2010, 2010, 2012, 2012, 2012, 2014, 2016, 2016, 2018, 2018]",4.571428571428571,0.032509444645719456,Low Gender Representation,0.21428571428571427,2
12085,1,1,2,"[2018, 2020]",0.0,1.0,Low Gender Representation not Detected,0.5,5
12086,48,70,118,"[1993, 1993, 1993, 1993, 1993, 1993, 1993, 1993, 1993, 1993, 1993, 1993, 1993, 1994, 1994, 1994, 1996, 1996, 1996, 1996, 1996, 1996, 1996, 1996, 1996, 1996, 1998, 1998, 1998, 1998, 1998, 2000, 2000, 2000, 2000, 2000, 2000, 2000, 2000, 2001, 2002, 2002, 2002, 2002, 2002, 2002, 2002, 2002, 2004, 2004, 2004, 2004, 2004, 2004, 2004, 2004, 2006, 2006, 2006, 2006, 2006, 2006, 2006, 2008, 2008, 2008, 2008, 2008, 2008, 2008, 2008, 2008, 2008, 2010, 2010, 2010, 2010, 2010, 2010, 2010, 2010, 2011, 2011, 2012, 2012, 2012, 2012, 2012, 2012, 2012, 2012, 2012, 2014, 2014, 2014, 2014, 2014, 2014, 2014, 2016, 2016, 2016, 2016, 2016, 2016, 2016, 2018, 2018, 2018, 2018, 2018, 2018, 2018, 2020, 2020, 2020, 2020, 2020, 2020, 2020]",4.101694915254237,0.04284024667327114,Low Gender Representation,0.4067796610169492,4
12091,2,5,7,"[1990, 1992, 1992, 1992, 1996, 2016, 2020]",1.2857142857142858,0.2568392579578533,Low Gender Representation not Detected,0.2857142857142857,3
12095,24,20,44,"[1992, 1992, 1992, 1994, 1994, 1994, 1996, 1996, 1996, 1998, 1998, 1998, 2000, 2000, 2000, 2002, 2002, 2002, 2004, 2004, 2004, 2006, 2006, 2006, 2008, 2008, 2010, 2010, 2010, 2012, 2012, 2014, 2014, 2014, 2016, 2016, 2016, 2018, 2018, 2018, 2018, 2020, 2020, 2020]",0.36363636363636365,0.5464935954065822,Low Gender Representation not Detected,0.5454545454545454,5
12097,8,26,34,"[1990, 1990, 1992, 1992, 1992, 1994, 1994, 1998, 1998, 2000, 2000, 2002, 2002, 2004, 2004, 2004, 2008, 2008, 2008, 2010, 2010, 2012, 2012, 2012, 2014, 2014, 2016, 2016, 2016, 2018, 2018, 2020, 2020, 2020]",9.529411764705882,0.002022049196903578,Low Gender Representation,0.23529411764705882,2
12099,29,27,56,"[1989, 1990, 1990, 1990, 1992, 1992, 1992, 1992, 1994, 1994, 1996, 1996, 1996, 1996, 1998, 1998, 1998, 2000, 2000, 2000, 2000, 2002, 2002, 2002, 2004, 2004, 2004, 2004, 2006, 2006, 2008, 2008, 2008, 2008, 2010, 2010, 2010, 2010, 2012, 2012, 2012, 2012, 2014, 2014, 2014, 2016, 2016, 2016, 2016, 2018, 2018, 2018, 2020, 2020, 2020, 2020]",0.07142857142857142,0.7892680261342813,Low Gender Representation not Detected,0.5178571428571429,5
12101,12,18,30,"[1990, 1990, 1992, 1992, 1994, 1994, 1996, 1996, 1998, 1998, 2000, 2000, 2002, 2004, 2004, 2006, 2008, 2008, 2008, 2010, 2010, 2012, 2014, 2016, 2016, 2016, 2018, 2018, 2020, 2020]",1.2,0.273321678292295,Low Gender Representation not Detected,0.4,4
12103,18,21,39,"[2000, 2000, 2000, 2002, 2002, 2002, 2002, 2004, 2004, 2004, 2004, 2006, 2006, 2006, 2008, 2008, 2008, 2008, 2010, 2010, 2010, 2012, 2012, 2012, 2012, 2014, 2014, 2014, 2016, 2016, 2016, 2016, 2018, 2018, 2018, 2018, 2020, 2020, 2020, 2020]",0.23076923076923078,0.6309540411841706,Low Gender Representation not Detected,0.46153846153846156,5
12105,3,14,17,"[1998, 2002, 2006, 2010, 2012, 2012, 2012, 2014, 2014, 2016, 2016, 2016, 2018, 2018, 2020, 2020, 2020]",7.117647058823529,0.007632881787792295,Low Gender Representation,0.17647058823529413,2
12109,6,15,21,"[1990, 1990, 1990, 1994, 1994, 1996, 1996, 1996, 1996, 1998, 1998, 2002, 2002, 2004, 2006, 2006, 2008, 2012, 2012, 2014, 2020, 2020]",3.857142857142857,0.04953461343562649,Low Gender Representation,0.2857142857142857,3
12111,9,13,22,"[1990, 2000, 2000, 2000, 2004, 2004, 2004, 2006, 2006, 2008, 2008, 2010, 2010, 2012, 2012, 2012, 2014, 2014, 2016, 2018, 2018, 2020, 2020, 2020]",0.7272727272727273,0.3937686346429926,Low Gender Representation not Detected,0.4090909090909091,4
12113,0,5,5,"[2010, 2014, 2014, 2016, 2018]",5.0,0.025347318677468325,Low Gender Representation,0.0,0
12115,4,10,14,"[2004, 2008, 2010, 2010, 2012, 2012, 2014, 2014, 2016, 2018, 2018, 2020, 2020, 2020]",2.5714285714285716,0.10880943004054605,Low Gender Representation not Detected,0.2857142857142857,3
12117,5,19,24,"[1992, 1994, 1994, 1996, 1996, 1996, 2000, 2000, 2000, 2002, 2002, 2004, 2004, 2004, 2006, 2008, 2010, 2010, 2012, 2012, 2018, 2018, 2020, 2020, 2020]",8.166666666666666,0.004266724822176128,Low Gender Representation,0.20833333333333334,2
12119,0,4,4,"[2008, 2008, 2012, 2012]",4.0,0.04550026389635857,Low Gender Representation,0.0,0
12127,14,17,31,"[1998, 1998, 1998, 1998, 1998, 2002, 2002, 2002, 2002, 2004, 2006, 2006, 2006, 2008, 2010, 2010, 2012, 2012, 2012, 2012, 2012, 2012, 2014, 2014, 2014, 2016, 2016, 2018, 2018, 2020, 2020]",0.2903225806451613,0.590013887163346,Low Gender Representation not Detected,0.45161290322580644,5
13015,0,1,1,[2020],1.0,0.31731050786291115,Low Gender Representation not Detected,0.0,0
13045,5,15,20,"[1998, 1998, 1998, 2004, 2004, 2004, 2004, 2008, 2008, 2008, 2010, 2010, 2010, 2014, 2014, 2014, 2016, 2016, 2016, 2018, 2018, 2020, 2020, 2020, 2020]",5.0,0.025347318677468325,Low Gender Representation,0.25,2
13051,11,30,41,"[2004, 2004, 2004, 2004, 2004, 2004, 2004, 2004, 2008, 2008, 2008, 2008, 2008, 2008, 2008, 2008, 2008, 2012, 2012, 2012, 2012, 2012, 2012, 2012, 2016, 2016, 2016, 2016, 2016, 2016, 2016, 2016, 2016, 2020, 2020, 2020, 2020, 2020, 2020, 2020, 2020, 2020, 2020]",8.804878048780488,0.0030042622393982856,Low Gender Representation,0.2682926829268293,3
13057,2,16,18,"[1992, 1992, 1994, 1994, 1994, 1996, 2006, 2006, 2006, 2010, 2010, 2010, 2012, 2012, 2014, 2014, 2014, 2016, 2016, 2018, 2018, 2020, 2020]",10.88888888888889,0.0009674284502477464,Low Gender Representation,0.1111111111111111,1
13059,0,1,1,[2020],1.0,0.31731050786291115,Low Gender Representation not Detected,0.0,0
13063,10,11,21,"[1994, 1994, 1996, 1996, 1996, 1998, 1998, 2000, 2000, 2002, 2004, 2004, 2004, 2004, 2006, 2006, 2008, 2008, 2008, 2010, 2010, 2012, 2012, 2012, 2014, 2016, 2016, 2018, 2018, 2020, 2020, 2020]",0.047619047619047616,0.8272593465627113,Low Gender Representation not Detected,0.47619047619047616,5
13067,10,11,21,"[1994, 1996, 2000, 2002, 2004, 2006, 2008, 2010, 2012, 2012, 2012, 2014, 2014, 2016, 2016, 2016, 2018, 2018, 2020, 2020, 2020]",0.047619047619047616,0.8272593465627113,Low Gender Representation not Detected,0.47619047619047616,5
13073,6,25,31,"[1990, 1990, 1992, 1992, 1992, 1994, 1994, 1996, 1996, 1996, 1998, 1998, 2000, 2000, 2000, 2004, 2004, 2004, 2006, 2006, 2006, 2008, 2008, 2010, 2010, 2010, 2012, 2012, 2014, 2014, 2014, 2016, 2016, 2018, 2018, 2020, 2020]",11.64516129032258,0.0006436975254696885,Low Gender Representation,0.1935483870967742,2
13077,0,3,3,"[2020, 2020, 2020]",3.0,0.08326451666355042,Low Gender Representation not Detected,0.0,0
13089,19,21,40,"[1994, 1996, 1996, 1996, 2002, 2002, 2004, 2004, 2004, 2004, 2006, 2006, 2008, 2008, 2008, 2008, 2010, 2010, 2010, 2012, 2012, 2012, 2012, 2014, 2014, 2014, 2014, 2014, 2015, 2015, 2016, 2016, 2016, 2016, 2016, 2016, 2018, 2018, 2020, 2020, 2020, 2020]",0.1,0.7518296340458492,Low Gender Representation not Detected,0.475,5
13097,1,1,2,"[2020, 2020]",0.0,1.0,Low Gender Representation not Detected,0.5,5
13113,4,33,37,"[1990, 1990, 1992, 1992, 1992, 1994, 1994, 1996, 1996, 1996, 1998, 1998, 2000, 2000, 2002, 2002, 2004, 2004, 2004, 2006, 2006, 2008, 2008, 2008, 2010, 2010, 2012, 2012, 2012, 2014, 2014, 2015, 2016, 2016, 2016, 2018, 2018, 2020, 2020, 2020]",22.72972972972973,1.864606348180602e-06,Low Gender Representation,0.10810810810810811,1
13117,8,31,39,"[1990, 1990, 1992, 1992, 1992, 1994, 1994, 1996, 1996, 1996, 1998, 1998, 2000, 2000, 2000, 2002, 2002, 2004, 2004, 2004, 2006, 2006, 2008, 2008, 2008, 2010, 2010, 2012, 2012, 2012, 2014, 2014, 2016, 2016, 2016, 2017, 2018, 2018, 2020, 2020, 2020]",13.564102564102564,0.00023055262079589375,Low Gender Representation,0.20512820512820512,2
13121,24,42,66,"[1990, 1990, 1990, 1990, 1990, 1990, 1990, 1993, 1993, 1993, 1994, 1994, 1994, 1994, 1994, 1994, 1994, 1998, 1998, 1998, 1998, 1998, 1998, 1998, 2002, 2002, 2002, 2002, 2002, 2002, 2002, 2003, 2006, 2006, 2006, 2006, 2006, 2006, 2006, 2010, 2010, 2010, 2010, 2010, 2010, 2010, 2014, 2014, 2014, 2014, 2014, 2014, 2014, 2016, 2016, 2016, 2017, 2017, 2017, 2018, 2018, 2018, 2019, 2020, 2020, 2020]",4.909090909090909,0.026715698447179477,Low Gender Representation,0.36363636363636365,4
13135,12,20,32,"[1994, 1996, 1996, 1998, 2000, 2000, 2000, 2002, 2002, 2004, 2004, 2004, 2006, 2006, 2008, 2008, 2008, 2010, 2010, 2011, 2012, 2012, 2012, 2014, 2014, 2016, 2016, 2016, 2018, 2018, 2020, 2020, 2020]",2.0,0.15729920705028105,Low Gender Representation not Detected,0.375,4
13139,1,4,5,"[1998, 1998, 2020, 2020, 2020]",1.8,0.17971249487899593,Low Gender Representation not Detected,0.2,2
13151,9,26,35,"[1992, 1994, 1994, 1996, 1996, 2002, 2004, 2004, 2004, 2004, 2006, 2006, 2008, 2008, 2008, 2008, 2010, 2010, 2012, 2012, 2012, 2012, 2014, 2014, 2014, 2014, 2016, 2016, 2016, 2018, 2018, 2018, 2020, 2020, 2020, 2021]",8.257142857142858,0.004059196365555051,Low Gender Representation,0.2571428571428571,3
13153,3,10,13,"[2008, 2008, 2008, 2010, 2010, 2012, 2012, 2012, 2014, 2014, 2018, 2018, 2020, 2020, 2020]",3.769230769230769,0.0522036353413146,Low Gender Representation not Detected,0.23076923076923078,2
13185,1,2,3,"[2016, 2016, 2020, 2020, 2020]",0.3333333333333333,0.5637028616507731,Low Gender Representation not Detected,0.3333333333333333,3
13217,1,7,8,"[2010, 2010, 2012, 2012, 2012, 2012, 2014, 2014]",4.5,0.033894853524689295,Low Gender Representation,0.125,1
13223,1,12,13,"[2010, 2010, 2010, 2014, 2014, 2014, 2016, 2016, 2018, 2018, 2018, 2020, 2020]",9.307692307692308,0.002281937253315446,Low Gender Representation,0.07692307692307693,1
13313,0,3,3,"[2020, 2020, 2020]",3.0,0.08326451666355042,Low Gender Representation not Detected,0.0,0
15001,39,93,132,"[1990, 1990, 1992, 1992, 1992, 1992, 1992, 1992, 1992, 1992, 1992, 1994, 1994, 1994, 1994, 1994, 1994, 1994, 1994, 1994, 1996, 1996, 1996, 1996, 1996, 1996, 1996, 1996, 1996, 1998, 1998, 1998, 1998, 1998, 1998, 1998, 1998, 1998, 2000, 2000, 2000, 2000, 2000, 2000, 2000, 2000, 2000, 2002, 2002, 2002, 2002, 2002, 2002, 2002, 2002, 2002, 2004, 2004, 2004, 2004, 2004, 2004, 2004, 2004, 2004, 2006, 2006, 2006, 2006, 2006, 2006, 2006, 2006, 2006, 2008, 2008, 2008, 2008, 2008, 2008, 2008, 2008, 2008, 2010, 2010, 2010, 2010, 2010, 2010, 2010, 2010, 2010, 2012, 2012, 2012, 2012, 2012, 2012, 2012, 2012, 2012, 2014, 2014, 2014, 2014, 2014, 2014, 2014, 2014, 2014, 2016, 2016, 2016, 2016, 2016, 2016, 2016, 2016, 2016, 2018, 2018, 2018, 2018, 2018, 2018, 2018, 2018, 2018, 2020, 2020, 2020, 2020, 2020, 2020, 2020, 2020, 2020]",22.09090909090909,2.600383125978477e-06,Low Gender Representation,0.29545454545454547,3
15003,28,58,86,"[1990, 1990, 1990, 1990, 1990, 1990, 1990, 1990, 1990, 1994, 1994, 1994, 1994, 1994, 1994, 1994, 1994, 1994, 1994, 1994, 1998, 1998, 1998, 1998, 1998, 1998, 1998, 1998, 1998, 2000, 2000, 2002, 2002, 2002, 2002, 2002, 2002, 2002, 2002, 2002, 2002, 2002, 2004, 2004, 2004, 2004, 2004, 2006, 2006, 2006, 2006, 2008, 2008, 2008, 2008, 2008, 2009, 2009, 2010, 2010, 2010, 2010, 2010, 2010, 2012, 2012, 2012, 2012, 2012, 2012, 2014, 2014, 2014, 2014, 2016, 2016, 2016, 2016, 2016, 2018, 2018, 2018, 2018, 2019, 2019, 2020, 2020, 2020, 2020, 2020]",10.465116279069768,0.0012164989001555205,Low Gender Representation,0.32558139534883723,3
15007,5,12,17,"[1990, 1992, 1994, 1996, 1998, 2000, 2002, 2004, 2006, 2008, 2010, 2011, 2012, 2014, 2016, 2018, 2020]",2.8823529411764706,0.08955507441364248,Low Gender Representation not Detected,0.29411764705882354,3
15009,40,99,139,"[1990, 1990, 1990, 1990, 1990, 1990, 1990, 1990, 1990, 1990, 1992, 1992, 1992, 1992, 1992, 1994, 1994, 1994, 1994, 1994, 1994, 1994, 1994, 1994, 1996, 1996, 1996, 1996, 1996, 1996, 1996, 1996, 1996, 1998, 1998, 1998, 1998, 1998, 1998, 1998, 1998, 1998, 2000, 2000, 2000, 2000, 2000, 2000, 2000, 2000, 2000, 2002, 2002, 2002, 2002, 2002, 2002, 2002, 2002, 2002, 2004, 2004, 2004, 2004, 2004, 2004, 2004, 2004, 2004, 2006, 2006, 2006, 2006, 2006, 2006, 2006, 2006, 2006, 2008, 2008, 2008, 2008, 2008, 2008, 2008, 2008, 2008, 2010, 2010, 2010, 2010, 2010, 2010, 2010, 2010, 2010, 2012, 2012, 2012, 2012, 2012, 2012, 2012, 2012, 2012, 2014, 2014, 2014, 2014, 2014, 2014, 2014, 2014, 2014, 2016, 2016, 2016, 2016, 2016, 2016, 2016, 2016, 2016, 2018, 2018, 2018, 2018, 2018, 2018, 2018, 2018, 2018, 2020, 2020, 2020, 2020, 2020, 2020, 2020, 2020, 2020, 2020]",25.0431654676259,5.606111276199412e-07,Low Gender Representation,0.28776978417266186,3
16001,3,9,12,"[2004, 2008, 2010, 2010, 2012, 2012, 2016, 2016, 2018, 2018, 2020, 2020]",3.0,0.08326451666355042,Low Gender Representation not Detected,0.25,2
16019,0,6,6,"[2016, 2016, 2018, 2018, 2020, 2020]",6.0,0.014305878435429641,Low Gender Representation,0.0,0
16027,7,5,12,"[1990, 1990, 1994, 1994, 1996, 1996, 2016, 2016, 2018, 2018, 2020, 2020]",0.3333333333333333,0.5637028616507731,Low Gender Representation not Detected,0.5833333333333334,6
16055,3,15,18,"[2004, 2004, 2006, 2006, 2008, 2008, 2010, 2010, 2012, 2012, 2014, 2014, 2016, 2016, 2018, 2018, 2020, 2020]",8.0,0.004677734981047276,Low Gender Representation,0.16666666666666666,2
17019,70,171,241,"[1990, 1990, 1990, 1990, 1990, 1990, 1990, 1990, 1990, 1990, 1990, 1990, 1990, 1990, 1992, 1992, 1992, 1992, 1992, 1992, 1992, 1992, 1992, 1992, 1992, 1992, 1992, 1992, 1992, 1992, 1992, 1992, 1992, 1992, 1992, 1992, 1992, 1992, 1992, 1992, 1992, 1994, 1994, 1994, 1994, 1994, 1994, 1994, 1994, 1994, 1994, 1994, 1994, 1994, 1994, 1994, 1996, 1996, 1996, 1996, 1996, 1996, 1996, 1996, 1996, 1996, 1996, 1996, 1996, 1998, 1998, 1998, 1998, 1998, 1998, 1998, 1998, 1998, 1998, 1998, 1998, 1998, 1998, 2000, 2000, 2000, 2000, 2000, 2000, 2000, 2000, 2000, 2000, 2000, 2000, 2000, 2000, 2002, 2002, 2002, 2002, 2002, 2002, 2002, 2002, 2002, 2002, 2002, 2002, 2002, 2002, 2002, 2002, 2002, 2002, 2002, 2002, 2002, 2002, 2002, 2002, 2002, 2002, 2002, 2004, 2004, 2004, 2004, 2004, 2004, 2004, 2004, 2004, 2004, 2004, 2004, 2004, 2004, 2006, 2006, 2006, 2006, 2006, 2006, 2006, 2006, 2006, 2006, 2006, 2006, 2006, 2006, 2006, 2008, 2008, 2008, 2008, 2008, 2008, 2008, 2008, 2008, 2008, 2008, 2008, 2008, 2010, 2010, 2010, 2010, 2010, 2010, 2010, 2010, 2010, 2010, 2010, 2010, 2010, 2010, 2010, 2012, 2012, 2012, 2012, 2012, 2012, 2012, 2012, 2012, 2012, 2012, 2012, 2012, 2012, 2012, 2012, 2012, 2012, 2012, 2012, 2012, 2012, 2014, 2014, 2014, 2014, 2014, 2014, 2014, 2014, 2014, 2014, 2014, 2016, 2016, 2016, 2016, 2016, 2016, 2016, 2016, 2016, 2016, 2016, 2018, 2018, 2018, 2018, 2018, 2018, 2018, 2018, 2018, 2018, 2018, 2020, 2020, 2020, 2020, 2020, 2020, 2020, 2020, 2020, 2020, 2020]",42.32780082987552,7.718750666527447e-11,Low Gender Representation,0.29045643153526973,3
17031,32,92,124,"[1994, 1994, 1994, 1994, 1994, 1994, 1994, 1994, 1994, 1994, 1994, 1994, 1994, 1994, 1994, 1994, 1997, 1998, 1998, 1998, 1998, 1998, 1998, 1998, 1998, 1998, 1998, 1998, 1998, 1998, 1998, 1998, 1998, 1998, 2002, 2002, 2002, 2002, 2002, 2002, 2002, 2002, 2002, 2002, 2002, 2002, 2002, 2002, 2002, 2002, 2002, 2006, 2006, 2006, 2006, 2006, 2006, 2006, 2006, 2006, 2006, 2006, 2006, 2006, 2006, 2006, 2006, 2006, 2006, 2009, 2009, 2010, 2010, 2010, 2010, 2010, 2010, 2010, 2010, 2010, 2010, 2010, 2010, 2010, 2010, 2010, 2010, 2010, 2013, 2014, 2014, 2014, 2014, 2014, 2014, 2014, 2014, 2014, 2014, 2014, 2014, 2014, 2014, 2014, 2014, 2014, 2016, 2017, 2018, 2018, 2018, 2018, 2018, 2018, 2018, 2018, 2018, 2018, 2018, 2018, 2018, 2018, 2018, 2018, 2018, 2020]",29.032258064516128,7.118304164714049e-08,Low Gender Representation,0.25806451612903225,3
17037,36,74,110,"[2006, 2006, 2006, 2006, 2006, 2006, 2006, 2006, 2006, 2006, 2006, 2006, 2008, 2008, 2008, 2008, 2008, 2008, 2008, 2008, 2008, 2008, 2008, 2008, 2010, 2010, 2010, 2010, 2010, 2010, 2010, 2010, 2010, 2010, 2010, 2010, 2012, 2012, 2012, 2012, 2012, 2012, 2012, 2012, 2012, 2012, 2012, 2012, 2012, 2012, 2012, 2012, 2012, 2012, 2012, 2012, 2012, 2012, 2012, 2012, 2014, 2014, 2014, 2014, 2014, 2014, 2014, 2014, 2014, 2014, 2014, 2014, 2014, 2016, 2016, 2016, 2016, 2016, 2016, 2016, 2016, 2016, 2016, 2016, 2016, 2018, 2018, 2018, 2018, 2018, 2018, 2018, 2018, 2018, 2018, 2018, 2018, 2020, 2020, 2020, 2020, 2020, 2020, 2020, 2020, 2020, 2020, 2020, 2020, 2020]",13.127272727272727,0.00029102810581780345,Low Gender Representation,0.32727272727272727,3
17043,43,93,136,"[1990, 1990, 1990, 1990, 1990, 1990, 1990, 1990, 1990, 1990, 1990, 1990, 1990, 1992, 1992, 1992, 1992, 1992, 1992, 1992, 1992, 1992, 1992, 1992, 1992, 1992, 1992, 1992, 1992, 1992, 1992, 1992, 1992, 1992, 1992, 1992, 1992, 1994, 1994, 1994, 1994, 1994, 1994, 1994, 1994, 1994, 1994, 1994, 1994, 1996, 1996, 1996, 1996, 1996, 1996, 1996, 1996, 1996, 1996, 1996, 2000, 2000, 2000, 2000, 2000, 2000, 2000, 2000, 2000, 2000, 2000, 2000, 2002, 2002, 2002, 2002, 2002, 2002, 2002, 2002, 2002, 2002, 2002, 2002, 2002, 2002, 2002, 2002, 2002, 2002, 2004, 2004, 2004, 2004, 2004, 2006, 2006, 2006, 2006, 2006, 2006, 2006, 2006, 2006, 2006, 2006, 2006, 2008, 2008, 2008, 2008, 2008, 2008, 2008, 2008, 2008, 2008, 2008, 2008, 2010, 2010, 2010, 2010, 2010, 2010, 2010, 2012, 2012, 2012, 2012, 2012, 2012, 2012, 2012, 2012, 2012, 2012, 2012, 2012, 2012, 2012, 2012, 2012, 2012, 2012, 2012, 2014, 2014, 2014, 2014, 2014, 2014, 2014, 2014, 2016, 2016, 2016, 2016, 2016, 2016, 2016, 2016, 2016, 2016, 2016, 2016, 2018, 2018, 2018, 2018, 2018, 2018, 2018, 2018, 2018, 2018, 2018, 2018, 2020, 2020, 2020, 2020, 2020, 2020, 2020, 2020]",18.38235294117647,1.807240237422998e-05,Low Gender Representation,0.3161764705882353,3
17089,64,113,177,"[1990, 1990, 1990, 1990, 1990, 1990, 1990, 1990, 1992, 1992, 1992, 1992, 1992, 1992, 1992, 1992, 1992, 1992, 1992, 1992, 1992, 1992, 1992, 1992, 1992, 1992, 1992, 1992, 1992, 1994, 1994, 1994, 1994, 1994, 1994, 1994, 1994, 1994, 1996, 1996, 1996, 1996, 1996, 1996, 1996, 1996, 1996, 1996, 1996, 1996, 1998, 1998, 1998, 1998, 1998, 2000, 2000, 2000, 2000, 2000, 2000, 2000, 2000, 2000, 2002, 2002, 2002, 2002, 2002, 2002, 2002, 2002, 2002, 2002, 2002, 2002, 2002, 2002, 2002, 2002, 2002, 2002, 2002, 2002, 2002, 2002, 2002, 2002, 2002, 2002, 2004, 2004, 2004, 2004, 2004, 2004, 2004, 2004, 2004, 2004, 2004, 2004, 2004, 2006, 2006, 2006, 2006, 2006, 2006, 2006, 2006, 2006, 2006, 2006, 2006, 2006, 2008, 2008, 2008, 2008, 2008, 2008, 2008, 2008, 2008, 2008, 2008, 2008, 2008, 2010, 2010, 2010, 2010, 2010, 2010, 2010, 2010, 2010, 2010, 2010, 2010, 2010, 2012, 2012, 2012, 2012, 2012, 2012, 2012, 2012, 2012, 2012, 2012, 2012, 2012, 2012, 2012, 2012, 2012, 2012, 2012, 2012, 2012, 2012, 2012, 2014, 2014, 2014, 2014, 2014, 2014, 2014, 2014, 2014, 2014, 2016, 2016, 2016, 2016, 2016, 2016, 2016, 2016, 2016, 2016, 2016, 2016, 2018, 2018, 2018, 2018, 2018, 2018, 2018, 2018, 2018, 2018, 2018, 2018, 2018, 2020, 2020, 2020, 2020, 2020, 2020, 2020, 2020, 2020, 2020, 2020, 2020]",13.564971751412429,0.000230445882776859,Low Gender Representation,0.3615819209039548,4
17091,11,33,44,"[2016, 2016, 2016, 2016, 2016, 2016, 2016, 2016, 2016, 2016, 2016, 2016, 2016, 2016, 2016, 2018, 2018, 2018, 2018, 2018, 2018, 2018, 2018, 2018, 2018, 2018, 2018, 2018, 2018, 2020, 2020, 2020, 2020, 2020, 2020, 2020, 2020, 2020, 2020, 2020, 2020, 2020, 2020, 2020]",11.0,0.0009111188771537126,Low Gender Representation,0.25,2
17093,17,23,40,"[2006, 2006, 2006, 2006, 2006, 2008, 2008, 2008, 2008, 2008, 2012, 2012, 2012, 2012, 2012, 2012, 2012, 2012, 2012, 2012, 2014, 2014, 2014, 2014, 2014, 2016, 2016, 2016, 2016, 2016, 2018, 2018, 2018, 2018, 2018, 2020, 2020, 2020, 2020, 2020]",0.9,0.34278171114790873,Low Gender Representation not Detected,0.425,4
17097,76,83,159,"[1990, 1990, 1990, 1990, 1990, 1990, 1990, 1990, 1990, 1990, 1990, 1990, 1992, 1992, 1992, 1992, 1992, 1992, 1992, 1992, 1992, 1992, 1992, 1992, 1992, 1992, 1992, 1992, 1992, 1992, 1992, 1994, 1994, 1994, 1994, 1994, 1994, 1996, 1996, 1996, 1996, 1996, 1996, 1996, 1996, 1996, 1996, 1996, 1996, 1996, 1996, 1996, 1996, 1998, 2000, 2000, 2000, 2000, 2000, 2000, 2000, 2002, 2002, 2002, 2002, 2002, 2002, 2002, 2002, 2002, 2002, 2002, 2002, 2002, 2002, 2002, 2002, 2002, 2002, 2002, 2002, 2002, 2002, 2002, 2004, 2004, 2004, 2004, 2004, 2004, 2004, 2006, 2006, 2006, 2006, 2006, 2006, 2006, 2006, 2006, 2006, 2006, 2006, 2006, 2008, 2008, 2008, 2008, 2008, 2008, 2008, 2008, 2008, 2008, 2008, 2008, 2008, 2008, 2009, 2009, 2010, 2010, 2010, 2010, 2010, 2010, 2010, 2010, 2011, 2012, 2012, 2012, 2012, 2012, 2012, 2012, 2012, 2012, 2012, 2012, 2012, 2012, 2012, 2012, 2012, 2012, 2012, 2012, 2012, 2012, 2014, 2014, 2014, 2014, 2014, 2014, 2014, 2016, 2016, 2016, 2016, 2016, 2016, 2016, 2016, 2016, 2016, 2016, 2016, 2016, 2016, 2018, 2018, 2018, 2018, 2018, 2018, 2018, 2018, 2018, 2018, 2018, 2018, 2018, 2018, 2020, 2020, 2020, 2020, 2020, 2020, 2020, 2020]",0.3081761006289308,0.5788015653238561,Low Gender Representation not Detected,0.4779874213836478,5
17099,10,35,45,"[2016, 2016, 2016, 2016, 2016, 2016, 2016, 2016, 2016, 2016, 2016, 2016, 2016, 2016, 2016, 2018, 2018, 2018, 2018, 2018, 2018, 2018, 2018, 2018, 2018, 2018, 2018, 2018, 2018, 2020, 2020, 2020, 2020, 2020, 2020, 2020, 2020, 2020, 2020, 2020, 2020, 2020, 2020, 2020, 2020]",13.88888888888889,0.0001939416291037193,Low Gender Representation,0.2222222222222222,2
17111,52,66,118,"[2000, 2000, 2000, 2000, 2000, 2000, 2000, 2000, 2000, 2000, 2000, 2000, 2002, 2002, 2002, 2002, 2002, 2002, 2002, 2002, 2002, 2002, 2002, 2002, 2004, 2004, 2004, 2004, 2004, 2004, 2004, 2004, 2004, 2004, 2004, 2004, 2006, 2006, 2006, 2006, 2006, 2006, 2006, 2006, 2006, 2006, 2006, 2006, 2008, 2008, 2008, 2008, 2008, 2008, 2008, 2008, 2008, 2008, 2008, 2008, 2010, 2010, 2010, 2010, 2010, 2010, 2010, 2010, 2010, 2010, 2010, 2010, 2012, 2012, 2012, 2012, 2012, 2012, 2012, 2012, 2012, 2012, 2012, 2012, 2014, 2014, 2014, 2014, 2014, 2014, 2016, 2016, 2016, 2016, 2016, 2016, 2016, 2016, 2016, 2016, 2016, 2016, 2018, 2018, 2018, 2018, 2018, 2018, 2020, 2020, 2020, 2020, 2020, 2020, 2020, 2020, 2020, 2020, 2020, 2020, 2020]",1.6610169491525424,0.19746607335801497,Low Gender Representation not Detected,0.4406779661016949,4
17113,34,118,152,"[1990, 1990, 1990, 1990, 1990, 1990, 1990, 1990, 1990, 1990, 1990, 1992, 1992, 1992, 1992, 1992, 1992, 1992, 1992, 1992, 1992, 1992, 1992, 1992, 1992, 1992, 1992, 1994, 1994, 1994, 1994, 1994, 1994, 1994, 1994, 1994, 1996, 1996, 1996, 1996, 1996, 1996, 1996, 1996, 1996, 1996, 1998, 1998, 1998, 1998, 1998, 1998, 1998, 1998, 1998, 1998, 2000, 2000, 2000, 2000, 2000, 2000, 2000, 2000, 2000, 2000, 2000, 2002, 2002, 2002, 2002, 2002, 2002, 2002, 2002, 2002, 2002, 2002, 2002, 2002, 2002, 2002, 2002, 2002, 2002, 2002, 2002, 2004, 2004, 2004, 2004, 2004, 2004, 2004, 2004, 2004, 2004, 2006, 2006, 2006, 2006, 2006, 2006, 2006, 2006, 2006, 2006, 2008, 2008, 2008, 2008, 2008, 2008, 2008, 2008, 2008, 2008, 2008, 2010, 2010, 2010, 2010, 2010, 2010, 2010, 2010, 2010, 2010, 2012, 2012, 2012, 2012, 2012, 2012, 2012, 2012, 2012, 2012, 2012, 2012, 2014, 2014, 2014, 2014, 2014, 2014, 2014, 2016, 2016, 2016, 2016, 2016, 2016, 2018, 2018, 2018, 2018, 2018, 2018, 2020, 2020, 2020, 2020, 2020, 2020]",46.421052631578945,9.538514342946386e-12,Low Gender Representation,0.2236842105263158,2
17115,8,14,22,"[2016, 2016, 2016, 2016, 2016, 2016, 2016, 2018, 2018, 2018, 2018, 2018, 2018, 2018, 2020, 2020, 2020, 2020, 2020, 2020, 2020, 2020]",1.6363636363636365,0.2008251226951417,Low Gender Representation not Detected,0.36363636363636365,4
17119,40,83,123,"[2008, 2008, 2008, 2008, 2008, 2008, 2008, 2008, 2008, 2008, 2008, 2008, 2008, 2008, 2008, 2008, 2010, 2010, 2010, 2010, 2010, 2010, 2010, 2010, 2010, 2010, 2010, 2010, 2010, 2010, 2010, 2010, 2012, 2012, 2012, 2012, 2012, 2012, 2012, 2012, 2012, 2012, 2012, 2012, 2012, 2012, 2012, 2012, 2012, 2012, 2012, 2012, 2012, 2012, 2012, 2012, 2012, 2012, 2012, 2012, 2012, 2012, 2014, 2014, 2014, 2014, 2014, 2014, 2014, 2014, 2014, 2014, 2016, 2016, 2016, 2016, 2016, 2016, 2016, 2016, 2016, 2016, 2016, 2016, 2016, 2016, 2016, 2016, 2016, 2016, 2016, 2016, 2018, 2018, 2018, 2018, 2018, 2018, 2018, 2018, 2018, 2018, 2018, 2018, 2018, 2018, 2018, 2018, 2018, 2018, 2018, 2020, 2020, 2020, 2020, 2020, 2020, 2020, 2020, 2020, 2020, 2020, 2020]",15.032520325203253,0.0001056744266166492,Low Gender Representation,0.3252032520325203,3
17143,32,86,118,"[2000, 2000, 2000, 2000, 2000, 2000, 2000, 2000, 2000, 2002, 2002, 2002, 2002, 2002, 2002, 2002, 2002, 2002, 2002, 2002, 2002, 2002, 2002, 2002, 2002, 2002, 2002, 2004, 2004, 2004, 2004, 2004, 2004, 2004, 2004, 2004, 2006, 2006, 2006, 2006, 2006, 2006, 2006, 2006, 2006, 2008, 2008, 2008, 2008, 2008, 2008, 2008, 2008, 2010, 2010, 2010, 2010, 2010, 2010, 2010, 2010, 2010, 2010, 2010, 2012, 2012, 2012, 2012, 2012, 2012, 2012, 2012, 2012, 2012, 2012, 2012, 2012, 2012, 2012, 2012, 2012, 2012, 2014, 2014, 2014, 2014, 2014, 2014, 2014, 2016, 2016, 2016, 2016, 2016, 2016, 2016, 2016, 2016, 2018, 2018, 2018, 2018, 2018, 2018, 2018, 2018, 2018, 2018, 2020, 2020, 2020, 2020, 2020, 2020, 2020, 2020, 2020, 2020]",24.71186440677966,6.657308982373516e-07,Low Gender Representation,0.2711864406779661,3
17161,55,206,261,"[1990, 1990, 1990, 1990, 1990, 1990, 1990, 1990, 1990, 1990, 1990, 1990, 1992, 1992, 1992, 1992, 1992, 1992, 1992, 1992, 1992, 1992, 1992, 1992, 1992, 1992, 1992, 1992, 1992, 1992, 1992, 1992, 1992, 1992, 1992, 1992, 1992, 1994, 1994, 1994, 1994, 1994, 1994, 1994, 1994, 1994, 1994, 1994, 1994, 1994, 1996, 1996, 1996, 1996, 1996, 1996, 1996, 1996, 1996, 1996, 1996, 1996, 1996, 1996, 1996, 1998, 1998, 1998, 1998, 1998, 1998, 1998, 1998, 1998, 1998, 1998, 1998, 1998, 2000, 2000, 2000, 2000, 2000, 2000, 2000, 2000, 2000, 2000, 2000, 2000, 2000, 2002, 2002, 2002, 2002, 2002, 2002, 2002, 2002, 2002, 2002, 2002, 2002, 2002, 2002, 2002, 2002, 2002, 2002, 2002, 2002, 2002, 2002, 2002, 2002, 2002, 2004, 2004, 2004, 2004, 2004, 2004, 2004, 2004, 2004, 2004, 2004, 2004, 2004, 2004, 2005, 2006, 2006, 2006, 2006, 2006, 2006, 2006, 2006, 2006, 2006, 2006, 2006, 2006, 2006, 2008, 2008, 2008, 2008, 2008, 2008, 2008, 2008, 2008, 2008, 2008, 2008, 2008, 2008, 2008, 2010, 2010, 2010, 2010, 2010, 2010, 2010, 2010, 2010, 2010, 2010, 2010, 2011, 2011, 2011, 2012, 2012, 2012, 2012, 2012, 2012, 2012, 2012, 2012, 2012, 2012, 2012, 2012, 2012, 2012, 2012, 2012, 2012, 2012, 2012, 2012, 2012, 2012, 2012, 2012, 2012, 2014, 2014, 2014, 2014, 2014, 2014, 2014, 2014, 2014, 2014, 2014, 2014, 2014, 2015, 2015, 2016, 2016, 2016, 2016, 2016, 2016, 2016, 2016, 2016, 2016, 2016, 2016, 2016, 2017, 2018, 2018, 2018, 2018, 2018, 2018, 2018, 2018, 2018, 2018, 2018, 2018, 2018, 2019, 2019, 2020, 2020, 2020, 2020, 2020, 2020, 2020, 2020, 2020, 2020, 2020, 2020, 2020, 2021, 2021, 2021, 2021]",87.36015325670498,9.04545953837121e-21,Low Gender Representation,0.210727969348659,2
17163,24,138,162,"[2000, 2000, 2000, 2000, 2000, 2000, 2000, 2000, 2000, 2000, 2002, 2002, 2002, 2002, 2002, 2002, 2002, 2002, 2002, 2002, 2002, 2002, 2002, 2002, 2002, 2002, 2002, 2002, 2002, 2002, 2002, 2002, 2002, 2002, 2002, 2002, 2004, 2004, 2004, 2004, 2004, 2004, 2004, 2004, 2004, 2006, 2006, 2006, 2006, 2006, 2006, 2006, 2006, 2006, 2006, 2006, 2006, 2006, 2006, 2006, 2006, 2006, 2008, 2008, 2008, 2008, 2008, 2008, 2008, 2008, 2008, 2008, 2008, 2008, 2008, 2008, 2008, 2008, 2008, 2008, 2008, 2010, 2010, 2010, 2010, 2010, 2010, 2010, 2010, 2010, 2010, 2010, 2012, 2012, 2012, 2012, 2012, 2012, 2012, 2012, 2012, 2012, 2012, 2012, 2012, 2012, 2012, 2012, 2012, 2012, 2012, 2012, 2012, 2012, 2012, 2012, 2012, 2012, 2012, 2012, 2012, 2014, 2014, 2014, 2014, 2014, 2014, 2014, 2014, 2014, 2014, 2016, 2016, 2016, 2016, 2016, 2016, 2016, 2016, 2016, 2016, 2016, 2016, 2016, 2016, 2016, 2016, 2016, 2016, 2016, 2016, 2020, 2020, 2020, 2020, 2020, 2020, 2020, 2020, 2020, 2020, 2020, 2020]",80.22222222222223,3.345831150392154e-19,Low Gender Representation,0.14814814814814814,1
17167,59,205,264,"[1990, 1990, 1990, 1990, 1990, 1990, 1990, 1990, 1990, 1990, 1990, 1990, 1990, 1990, 1990, 1992, 1992, 1992, 1992, 1992, 1992, 1992, 1992, 1992, 1992, 1992, 1992, 1992, 1992, 1992, 1992, 1992, 1992, 1992, 1992, 1992, 1992, 1992, 1992, 1992, 1992, 1992, 1992, 1992, 1994, 1994, 1994, 1994, 1994, 1994, 1994, 1994, 1994, 1994, 1994, 1994, 1994, 1994, 1994, 1994, 1996, 1996, 1996, 1996, 1996, 1996, 1996, 1996, 1996, 1996, 1996, 1996, 1996, 1996, 1998, 1998, 1998, 1998, 1998, 1998, 1998, 1998, 1998, 1998, 1998, 1998, 1998, 1998, 1998, 2000, 2000, 2000, 2000, 2000, 2000, 2000, 2000, 2000, 2000, 2000, 2000, 2000, 2000, 2000, 2000, 2002, 2002, 2002, 2002, 2002, 2002, 2002, 2002, 2002, 2002, 2002, 2002, 2002, 2002, 2002, 2002, 2002, 2002, 2002, 2002, 2002, 2002, 2002, 2002, 2002, 2002, 2002, 2002, 2002, 2004, 2004, 2004, 2004, 2004, 2004, 2004, 2004, 2004, 2004, 2004, 2004, 2004, 2004, 2006, 2006, 2006, 2006, 2006, 2006, 2006, 2006, 2006, 2006, 2006, 2006, 2006, 2006, 2006, 2008, 2008, 2008, 2008, 2008, 2008, 2008, 2008, 2008, 2008, 2008, 2008, 2008, 2008, 2008, 2008, 2008, 2010, 2010, 2010, 2010, 2010, 2010, 2010, 2010, 2010, 2010, 2010, 2010, 2010, 2010, 2010, 2012, 2012, 2012, 2012, 2012, 2012, 2012, 2012, 2012, 2012, 2012, 2012, 2012, 2012, 2012, 2012, 2012, 2012, 2012, 2012, 2012, 2012, 2012, 2012, 2012, 2012, 2012, 2012, 2012, 2014, 2014, 2014, 2014, 2014, 2014, 2014, 2014, 2014, 2014, 2014, 2014, 2014, 2014, 2018, 2018, 2018, 2018, 2018, 2018, 2018, 2018, 2018, 2018, 2018, 2018, 2020, 2020, 2020, 2020, 2020, 2020, 2020, 2020, 2020, 2020, 2020, 2020, 2020, 2020, 2020]",80.74242424242425,2.5714194753716995e-19,Low Gender Representation,0.22348484848484848,2
17179,17,64,81,"[2006, 2006, 2006, 2006, 2006, 2006, 2006, 2006, 2006, 2006, 2006, 2006, 2008, 2008, 2008, 2008, 2008, 2008, 2008, 2008, 2008, 2008, 2010, 2010, 2010, 2010, 2010, 2010, 2010, 2010, 2010, 2010, 2010, 2010, 2012, 2012, 2012, 2012, 2012, 2012, 2012, 2012, 2012, 2012, 2012, 2012, 2012, 2012, 2012, 2012, 2012, 2012, 2012, 2012, 2012, 2012, 2014, 2014, 2014, 2014, 2014, 2014, 2014, 2014, 2014, 2014, 2014, 2020, 2020, 2020, 2020, 2020, 2020, 2020, 2020, 2020, 2020, 2020, 2020, 2020, 2020]",27.271604938271604,1.7678863230465528e-07,Low Gender Representation,0.20987654320987653,2
17197,55,98,153,"[1990, 1990, 1990, 1990, 1990, 1990, 1990, 1990, 1990, 1990, 1990, 1990, 1990, 1990, 1990, 1990, 1992, 1992, 1992, 1992, 1992, 1992, 1992, 1992, 1992, 1992, 1992, 1992, 1992, 1992, 1992, 1992, 1992, 1992, 1992, 1992, 1992, 1992, 1992, 1992, 1992, 1992, 1992, 1994, 1994, 1994, 1994, 1994, 1994, 1994, 1994, 1994, 1996, 1996, 1996, 1996, 1996, 1996, 1996, 1996, 1996, 1996, 1996, 1996, 1996, 1996, 1996, 1996, 1996, 1996, 1998, 2000, 2000, 2000, 2000, 2000, 2000, 2000, 2000, 2000, 2000, 2002, 2002, 2002, 2002, 2002, 2002, 2002, 2002, 2002, 2002, 2002, 2002, 2002, 2002, 2002, 2002, 2002, 2002, 2002, 2002, 2002, 2002, 2002, 2002, 2002, 2002, 2002, 2004, 2004, 2004, 2004, 2004, 2004, 2004, 2004, 2004, 2004, 2004, 2006, 2006, 2006, 2006, 2006, 2006, 2006, 2006, 2006, 2006, 2006, 2006, 2006, 2006, 2006, 2006, 2006, 2006, 2008, 2008, 2008, 2008, 2008, 2008, 2008, 2008, 2008, 2008, 2008, 2008, 2008, 2008, 2008, 2008, 2008, 2008, 2010, 2010, 2010, 2010, 2010, 2010, 2010, 2010, 2010, 2010, 2012, 2012, 2012, 2012, 2012, 2012, 2012, 2012, 2012, 2012, 2012, 2012, 2012, 2014, 2014, 2014, 2014, 2016, 2016, 2016, 2016, 2016, 2016, 2016, 2016, 2016, 2018, 2018, 2018, 2018, 2018, 2018, 2018, 2018, 2020, 2020, 2020, 2020, 2020, 2020, 2020]",12.084967320261438,0.0005082999236623554,Low Gender Representation,0.35947712418300654,4
17201,42,158,200,"[1990, 1990, 1990, 1990, 1990, 1990, 1990, 1990, 1990, 1990, 1992, 1992, 1992, 1992, 1992, 1992, 1992, 1992, 1992, 1992, 1992, 1992, 1992, 1992, 1992, 1992, 1992, 1992, 1992, 1992, 1992, 1992, 1994, 1994, 1994, 1994, 1994, 1994, 1994, 1994, 1994, 1994, 1994, 1996, 1996, 1996, 1996, 1996, 1996, 1996, 1996, 1996, 1996, 1996, 1996, 1998, 1998, 1998, 1998, 1998, 1998, 1998, 1998, 1998, 1998, 1998, 1998, 1998, 2000, 2000, 2000, 2000, 2000, 2000, 2000, 2000, 2000, 2000, 2000, 2000, 2002, 2002, 2002, 2002, 2002, 2002, 2002, 2002, 2002, 2002, 2002, 2002, 2002, 2002, 2002, 2002, 2002, 2002, 2002, 2002, 2002, 2002, 2002, 2002, 2004, 2004, 2004, 2004, 2004, 2004, 2004, 2004, 2004, 2004, 2004, 2004, 2006, 2006, 2006, 2006, 2006, 2006, 2006, 2006, 2006, 2006, 2006, 2006, 2006, 2006, 2006, 2008, 2008, 2008, 2008, 2008, 2008, 2008, 2008, 2008, 2008, 2008, 2008, 2008, 2008, 2010, 2010, 2010, 2010, 2010, 2010, 2010, 2010, 2010, 2010, 2010, 2010, 2010, 2012, 2012, 2012, 2012, 2012, 2012, 2012, 2012, 2012, 2012, 2012, 2012, 2012, 2012, 2012, 2012, 2012, 2016, 2016, 2016, 2016, 2016, 2016, 2016, 2016, 2016, 2018, 2018, 2018, 2018, 2018, 2018, 2018, 2018, 2018, 2020, 2020, 2020, 2020, 2020, 2020, 2020, 2020, 2020]",67.28,2.3555893751564456e-16,Low Gender Representation,0.21,2
18003,11,41,52,"[1990, 1990, 1990, 1990, 1992, 1992, 1992, 1994, 1994, 1994, 1994, 1996, 1996, 1996, 1998, 1998, 1998, 1998, 2002, 2002, 2002, 2002, 2004, 2004, 2004, 2006, 2006, 2006, 2006, 2008, 2008, 2008, 2010, 2010, 2010, 2010, 2012, 2012, 2012, 2014, 2014, 2014, 2014, 2016, 2016, 2016, 2016, 2018, 2018, 2018, 2018, 2020]",17.307692307692307,3.178973761746535e-05,Low Gender Representation,0.21153846153846154,2
18019,7,7,14,"[2012, 2012, 2012, 2016, 2016, 2016, 2016, 2016, 2018, 2018, 2018, 2018, 2020, 2020]",0.0,1.0,Low Gender Representation not Detected,0.5,5
18035,8,17,25,"[2008, 2008, 2008, 2010, 2010, 2010, 2010, 2012, 2012, 2012, 2014, 2014, 2014, 2014, 2016, 2016, 2016, 2016, 2016, 2018, 2018, 2018, 2018, 2020, 2020]",3.24,0.07186063822585143,Low Gender Representation not Detected,0.32,3
18039,2,11,13,"[2014, 2014, 2014, 2014, 2016, 2016, 2016, 2018, 2018, 2018, 2018, 2020, 2020]",6.230769230769231,0.01255491859696653,Low Gender Representation,0.15384615384615385,2
18057,14,38,52,"[1992, 1992, 1994, 1994, 1994, 1994, 1996, 1996, 1996, 1998, 1998, 1998, 1998, 2000, 2000, 2000, 2002, 2002, 2002, 2002, 2004, 2004, 2004, 2006, 2006, 2006, 2006, 2008, 2008, 2008, 2010, 2010, 2010, 2010, 2012, 2012, 2012, 2014, 2014, 2014, 2014, 2016, 2016, 2016, 2016, 2016, 2018, 2018, 2018, 2018, 2020, 2020]",11.076923076923077,0.0008740872112984756,Low Gender Representation,0.2692307692307692,3
18063,2,19,21,"[2008, 2008, 2008, 2012, 2012, 2012, 2014, 2014, 2014, 2014, 2016, 2016, 2016, 2016, 2016, 2018, 2018, 2018, 2018, 2020, 2020]",13.761904761904763,0.0002075015940618336,Low Gender Representation,0.09523809523809523,1
18081,3,22,25,"[2008, 2008, 2008, 2010, 2010, 2010, 2010, 2012, 2012, 2012, 2014, 2014, 2014, 2014, 2016, 2016, 2016, 2016, 2016, 2018, 2018, 2018, 2018, 2020, 2020]",14.44,0.00014469608785024014,Low Gender Representation,0.12,1
18089,6,19,25,"[2010, 2010, 2010, 2010, 2010, 2010, 2010, 2014, 2014, 2014, 2014, 2014, 2014, 2014, 2016, 2016, 2018, 2018, 2018, 2018, 2018, 2018, 2018, 2020, 2020]",6.76,0.009322376047437499,Low Gender Representation,0.24,2
18091,4,21,25,"[2008, 2008, 2008, 2010, 2010, 2010, 2010, 2012, 2012, 2012, 2014, 2014, 2014, 2014, 2016, 2016, 2016, 2016, 2016, 2018, 2018, 2018, 2018, 2020, 2020]",11.56,0.0006738585313537617,Low Gender Representation,0.16,2
18095,3,9,12,"[2016, 2016, 2016, 2016, 2016, 2018, 2018, 2018, 2018, 2018, 2020, 2020]",3.0,0.08326451666355042,Low Gender Representation not Detected,0.25,2
18105,15,10,25,"[2008, 2008, 2008, 2010, 2010, 2010, 2010, 2012, 2012, 2012, 2014, 2014, 2014, 2014, 2016, 2016, 2016, 2016, 2016, 2018, 2018, 2018, 2018, 2020, 2020]",1.0,0.31731050786291115,Low Gender Representation not Detected,0.6,6
18127,9,20,29,"[2006, 2006, 2006, 2006, 2008, 2008, 2008, 2010, 2010, 2010, 2010, 2012, 2012, 2012, 2014, 2014, 2014, 2014, 2016, 2016, 2016, 2016, 2016, 2018, 2018, 2018, 2018, 2020, 2020]",4.172413793103448,0.04108722452782139,Low Gender Representation,0.3103448275862069,3
18141,3,7,10,"[2016, 2016, 2018, 2018, 2018, 2018, 2018, 2018, 2020, 2020]",1.6,0.20590321073206466,Low Gender Representation not Detected,0.3,3
18157,12,31,43,"[1998, 1998, 1998, 1998, 2000, 2000, 2000, 2002, 2002, 2002, 2002, 2004, 2004, 2004, 2006, 2006, 2006, 2006, 2008, 2008, 2008, 2010, 2010, 2010, 2010, 2012, 2012, 2012, 2014, 2014, 2014, 2014, 2016, 2016, 2016, 2016, 2016, 2018, 2018, 2018, 2018, 2020, 2020]",8.395348837209303,0.003761823132794379,Low Gender Representation,0.27906976744186046,3
18163,10,46,56,"[1990, 1990, 1990, 1990, 1992, 1992, 1992, 1994, 1994, 1994, 1994, 1996, 1996, 1996, 1998, 1998, 1998, 1998, 2000, 2000, 2000, 2002, 2002, 2002, 2002, 2004, 2004, 2004, 2006, 2006, 2006, 2006, 2008, 2008, 2008, 2010, 2010, 2010, 2010, 2012, 2012, 2012, 2014, 2014, 2014, 2014, 2016, 2016, 2016, 2016, 2018, 2018, 2018, 2018, 2020, 2020]",23.142857142857142,1.5040084860090868e-06,Low Gender Representation,0.17857142857142858,2
18167,2,9,11,"[2016, 2016, 2016, 2016, 2016, 2018, 2018, 2018, 2018, 2020, 2020]",4.454545454545454,0.03480847881186725,Low Gender Representation,0.18181818181818182,2
19013,4,25,29,"[1990, 1990, 1992, 1992, 1992, 1994, 1994, 1996, 1996, 1996, 1998, 1998, 2002, 2002, 2004, 2004, 2004, 2006, 2006, 2008, 2008, 2008, 2012, 2012, 2012, 2014, 2014, 2016, 2018]",15.206896551724139,9.635090009780229e-05,Low Gender Representation,0.13793103448275862,1
19103,12,21,33,"[1990, 1990, 1992, 1992, 1994, 1994, 1996, 1996, 1996, 1998, 1998, 2000, 2000, 2000, 2002, 2002, 2004, 2004, 2004, 2006, 2006, 2008, 2008, 2008, 2010, 2010, 2012, 2012, 2012, 2014, 2014, 2016, 2018]",2.4545454545454546,0.11718508719813815,Low Gender Representation not Detected,0.36363636363636365,4
19113,6,20,26,"[1990, 1992, 1992, 1994, 1996, 1996, 1998, 2000, 2000, 2008, 2008, 2008, 2010, 2010, 2012, 2012, 2012, 2014, 2014, 2016, 2016, 2016, 2018, 2018, 2018, 2020]",7.538461538461538,0.006039559048656826,Low Gender Representation,0.23076923076923078,2
19153,4,21,25,"[2000, 2000, 2002, 2002, 2002, 2002, 2004, 2004, 2006, 2006, 2006, 2008, 2008, 2010, 2010, 2010, 2012, 2012, 2014, 2014, 2014, 2016, 2016, 2020, 2020]",11.56,0.0006738585313537617,Low Gender Representation,0.16,2
19163,0,25,25,"[1990, 1990, 1990, 1992, 1992, 1994, 1994, 1994, 1996, 1996, 1998, 1998, 1998, 2000, 2000, 2002, 2004, 2006, 2008, 2010, 2012, 2014, 2016, 2018, 2020]",25.0,5.733031437583875e-07,Low Gender Representation,0.0,0
19193,1,11,12,"[2010, 2010, 2012, 2012, 2012, 2014, 2014, 2016, 2016, 2016, 2018, 2018]",8.333333333333334,0.003892417122778637,Low Gender Representation,0.08333333333333333,1
20045,4,18,22,"[1990, 1992, 1992, 1994, 1996, 1996, 1998, 2000, 2000, 2002, 2004, 2004, 2006, 2008, 2008, 2010, 2012, 2012, 2014, 2016, 2016, 2018]",8.909090909090908,0.0028375448887923106,Low Gender Representation,0.18181818181818182,2
20091,9,31,40,"[1992, 1996, 1998, 1998, 1998, 2000, 2000, 2002, 2002, 2002, 2002, 2004, 2004, 2004, 2006, 2006, 2006, 2008, 2008, 2008, 2010, 2010, 2010, 2012, 2012, 2012, 2014, 2014, 2014, 2016, 2016, 2016, 2018, 2018, 2018, 2018, 2018, 2020, 2020, 2020]",12.1,0.0005042182294490053,Low Gender Representation,0.225,2
20173,4,23,27,"[2000, 2000, 2002, 2002, 2002, 2004, 2004, 2006, 2006, 2006, 2008, 2008, 2010, 2010, 2010, 2012, 2012, 2014, 2014, 2014, 2016, 2016, 2018, 2018, 2018, 2020, 2020]",13.37037037037037,0.0002556308678365151,Low Gender Representation,0.14814814814814814,1
20177,3,10,13,"[2002, 2004, 2004, 2006, 2008, 2008, 2010, 2012, 2012, 2014, 2016, 2016, 2018]",3.769230769230769,0.0522036353413146,Low Gender Representation not Detected,0.23076923076923078,2
20209,11,36,47,"[1997, 1997, 1997, 1997, 1997, 1997, 1997, 1997, 1997, 1999, 1999, 1999, 1999, 1999, 2001, 2001, 2001, 2001, 2001, 2009, 2009, 2009, 2009, 2009, 2013, 2013, 2013, 2013, 2013, 2015, 2015, 2015, 2015, 2015, 2017, 2017, 2017, 2017, 2017, 2019, 2019, 2019, 2019, 2019, 2021, 2021, 2021, 2021, 2021]",13.297872340425531,0.00026570747090166305,Low Gender Representation,0.23404255319148937,2
21059,0,3,3,"[2006, 2006, 2006]",3.0,0.08326451666355042,Low Gender Representation not Detected,0.0,0
21067,34,73,107,"[2002, 2002, 2002, 2002, 2002, 2002, 2002, 2002, 2002, 2002, 2002, 2002, 2002, 2002, 2002, 2004, 2004, 2004, 2004, 2004, 2004, 2004, 2004, 2004, 2004, 2004, 2004, 2006, 2006, 2006, 2006, 2006, 2006, 2006, 2006, 2006, 2006, 2006, 2006, 2006, 2006, 2006, 2008, 2008, 2008, 2008, 2008, 2008, 2008, 2008, 2008, 2008, 2008, 2008, 2010, 2010, 2010, 2010, 2010, 2010, 2010, 2010, 2010, 2010, 2010, 2010, 2010, 2010, 2010, 2012, 2012, 2012, 2012, 2012, 2012, 2012, 2012, 2012, 2012, 2012, 2012, 2014, 2014, 2014, 2014, 2014, 2014, 2014, 2014, 2014, 2014, 2014, 2014, 2014, 2014, 2014, 2020, 2020, 2020, 2020, 2020, 2020, 2020, 2020, 2020, 2020, 2020, 2020]",14.214953271028037,0.00016306952101742574,Low Gender Representation,0.3177570093457944,3
21111,45,74,119,"[2002, 2002, 2002, 2002, 2002, 2002, 2002, 2002, 2002, 2002, 2002, 2002, 2002, 2002, 2002, 2002, 2002, 2002, 2002, 2002, 2002, 2002, 2002, 2002, 2002, 2002, 2004, 2004, 2004, 2004, 2004, 2004, 2004, 2004, 2004, 2004, 2004, 2004, 2004, 2006, 2006, 2006, 2006, 2006, 2006, 2006, 2006, 2006, 2006, 2006, 2006, 2006, 2006, 2008, 2008, 2008, 2008, 2008, 2008, 2008, 2008, 2008, 2008, 2008, 2008, 2008, 2010, 2010, 2010, 2010, 2010, 2010, 2010, 2010, 2010, 2010, 2010, 2010, 2010, 2010, 2012, 2012, 2012, 2012, 2012, 2012, 2012, 2012, 2012, 2012, 2012, 2012, 2012, 2012, 2014, 2014, 2014, 2014, 2014, 2014, 2014, 2014, 2014, 2014, 2014, 2014, 2014, 2020, 2020, 2020, 2020, 2020, 2020, 2020, 2020, 2020, 2020, 2020, 2020, 2020]",7.067226890756302,0.007850667267548366,Low Gender Representation,0.37815126050420167,4
22017,5,31,36,"[2011, 2011, 2011, 2011, 2011, 2011, 2011, 2011, 2011, 2011, 2011, 2011, 2013, 2015, 2015, 2015, 2015, 2015, 2015, 2015, 2015, 2015, 2015, 2015, 2015, 2019, 2019, 2019, 2019, 2019, 2019, 2019, 2019, 2019, 2019, 2019, 2019]",18.77777777777778,1.4686847673789383e-05,Low Gender Representation,0.1388888888888889,1
22033,28,63,91,"[1992, 1992, 1992, 1992, 1992, 1995, 1996, 1996, 1996, 1996, 1996, 1996, 1996, 1996, 1996, 1996, 1996, 1996, 2000, 2000, 2000, 2000, 2000, 2000, 2000, 2000, 2000, 2000, 2000, 2000, 2001, 2004, 2004, 2004, 2004, 2004, 2004, 2004, 2004, 2004, 2004, 2004, 2004, 2006, 2008, 2008, 2008, 2008, 2008, 2008, 2008, 2008, 2008, 2008, 2008, 2008, 2012, 2012, 2012, 2012, 2012, 2012, 2012, 2012, 2012, 2012, 2012, 2012, 2016, 2016, 2016, 2016, 2016, 2016, 2016, 2016, 2016, 2016, 2016, 2016, 2018, 2019, 2020, 2020, 2020, 2020, 2020, 2020, 2020, 2020, 2020, 2020, 2020, 2020]",13.461538461538462,0.00024350400440314806,Low Gender Representation,0.3076923076923077,3
22051,8,46,54,"[1991, 1991, 1991, 1991, 1991, 1995, 1995, 1995, 1995, 1995, 1999, 1999, 1999, 1999, 1999, 2003, 2003, 2003, 2003, 2003, 2003, 2003, 2007, 2007, 2007, 2007, 2007, 2007, 2007, 2009, 2011, 2011, 2011, 2011, 2011, 2011, 2011, 2011, 2015, 2015, 2015, 2015, 2015, 2015, 2015, 2017, 2017, 2019, 2019, 2019, 2019, 2019, 2019, 2019]",26.74074074074074,2.3266392076021818e-07,Low Gender Representation,0.14814814814814814,1
22055,0,30,30,"[1999, 1999, 1999, 1999, 1999, 2003, 2003, 2003, 2003, 2003, 2007, 2007, 2007, 2007, 2007, 2011, 2011, 2011, 2011, 2011, 2015, 2015, 2015, 2015, 2015, 2019, 2019, 2019, 2019, 2019]",30.0,4.3204630578274955e-08,Low Gender Representation,0.0,0
22103,5,23,28,"[2003, 2007, 2007, 2011, 2015, 2015, 2015, 2015, 2015, 2015, 2015, 2015, 2015, 2015, 2015, 2015, 2015, 2015, 2019, 2019, 2019, 2019, 2019, 2019, 2019, 2019, 2019, 2019, 2019, 2019, 2019, 2019, 2020, 2021]",11.571428571428571,0.0006697294490218293,Low Gender Representation,0.17857142857142858,2
23001,7,11,18,"[2008, 2008, 2010, 2012, 2012, 2014, 2014, 2014, 2014, 2014, 2016, 2016, 2016, 2018, 2018, 2018, 2018, 2018]",0.8888888888888888,0.3457785861511601,Low Gender Representation not Detected,0.3888888888888889,4
23005,7,14,21,"[1996, 2000, 2004, 2006, 2008, 2008, 2010, 2011, 2011, 2011, 2012, 2012, 2012, 2014, 2014, 2014, 2016, 2016, 2018, 2018, 2018]",2.3333333333333335,0.12663045794761726,Low Gender Representation not Detected,0.3333333333333333,3
23011,6,4,10,"[1994, 2008, 2008, 2010, 2012, 2012, 2014, 2016, 2016, 2018]",0.4,0.5270892568655381,Low Gender Representation not Detected,0.6,6
23019,2,7,9,"[2008, 2008, 2010, 2012, 2012, 2014, 2016, 2016, 2018]",2.7777777777777777,0.09558070454562936,Low Gender Representation not Detected,0.2222222222222222,2
23031,2,13,15,"[2008, 2008, 2010, 2010, 2010, 2010, 2012, 2012, 2014, 2014, 2014, 2016, 2016, 2018, 2018, 2018]",8.066666666666666,0.004508698364904238,Low Gender Representation,0.13333333333333333,1
24001,0,8,8,"[1998, 1998, 1998, 2002, 2006, 2010, 2014, 2018]",8.0,0.004677734981047276,Low Gender Representation,0.0,0
24003,15,41,56,"[1990, 1990, 1990, 1990, 1990, 1990, 1990, 1994, 1994, 1994, 1994, 1994, 1994, 1994, 1998, 1998, 1998, 1998, 1998, 1998, 1998, 2002, 2002, 2002, 2002, 2002, 2002, 2002, 2006, 2006, 2006, 2006, 2006, 2006, 2006, 2010, 2010, 2010, 2010, 2010, 2010, 2010, 2012, 2014, 2014, 2014, 2014, 2014, 2014, 2014, 2018, 2018, 2018, 2018, 2018, 2018, 2018]",12.071428571428571,0.0005120045221899044,Low Gender Representation,0.26785714285714285,3
24005,9,57,66,"[1990, 1990, 1990, 1990, 1990, 1990, 1990, 1994, 1994, 1994, 1994, 1994, 1994, 1994, 1998, 1998, 1998, 1998, 1998, 1998, 1998, 2002, 2002, 2002, 2002, 2002, 2002, 2002, 2006, 2006, 2006, 2006, 2006, 2006, 2006, 2010, 2010, 2010, 2010, 2010, 2010, 2010, 2014, 2014, 2014, 2014, 2014, 2014, 2014, 2016, 2016, 2016, 2016, 2016, 2016, 2016, 2016, 2016, 2016, 2016, 2016, 2016, 2016, 2018, 2018, 2018, 2018, 2018, 2018, 2018]",34.90909090909091,3.4546408775161435e-09,Low Gender Representation,0.13636363636363635,1
24009,1,4,5,"[2002, 2006, 2010, 2014, 2018]",1.8,0.17971249487899593,Low Gender Representation not Detected,0.2,2
24013,5,10,15,"[1990, 1990, 1990, 1994, 1994, 1994, 1998, 1998, 1998, 2002, 2006, 2018, 2018, 2018, 2018, 2018]",1.6666666666666667,0.1967056024589432,Low Gender Representation not Detected,0.3333333333333333,3
24015,8,22,30,"[1998, 1998, 1998, 2002, 2002, 2002, 2002, 2002, 2004, 2004, 2006, 2006, 2006, 2008, 2008, 2010, 2010, 2010, 2012, 2012, 2014, 2014, 2014, 2016, 2016, 2018, 2018, 2018, 2020, 2020]",6.533333333333333,0.010587137334056926,Low Gender Representation,0.26666666666666666,3
24017,9,18,27,"[1998, 1998, 1998, 1998, 1998, 2002, 2002, 2002, 2002, 2005, 2005, 2006, 2006, 2006, 2006, 2010, 2010, 2010, 2010, 2010, 2014, 2014, 2014, 2014, 2018, 2018, 2018, 2018, 2018]",3.0,0.08326451666355042,Low Gender Representation not Detected,0.3333333333333333,3
24021,4,10,14,"[1998, 1998, 1998, 1998, 1998, 2002, 2006, 2010, 2014, 2018, 2018, 2018, 2018, 2018, 2018]",2.5714285714285716,0.10880943004054605,Low Gender Representation not Detected,0.2857142857142857,3
24025,14,43,57,"[1990, 1990, 1990, 1990, 1990, 1990, 1990, 1994, 1994, 1994, 1994, 1994, 1994, 1994, 1998, 1998, 1998, 1998, 1998, 1998, 1998, 2002, 2002, 2002, 2002, 2002, 2002, 2002, 2006, 2006, 2006, 2006, 2006, 2006, 2006, 2009, 2010, 2010, 2010, 2010, 2010, 2010, 2010, 2014, 2014, 2014, 2014, 2014, 2014, 2014, 2018, 2018, 2018, 2018, 2018, 2018, 2018]",14.75438596491228,0.00012246232654541248,Low Gender Representation,0.24561403508771928,2
24027,12,24,36,"[1990, 1990, 1990, 1990, 1990, 1998, 1998, 1998, 1998, 1998, 2002, 2002, 2002, 2002, 2002, 2004, 2006, 2006, 2006, 2006, 2006, 2010, 2010, 2010, 2010, 2010, 2014, 2014, 2014, 2014, 2014, 2018, 2018, 2018, 2018, 2018]",4.0,0.04550026389635857,Low Gender Representation,0.3333333333333333,3
24031,21,35,56,"[1990, 1990, 1990, 1990, 1990, 1990, 1990, 1990, 1990, 1994, 1994, 1994, 1994, 1994, 1994, 1994, 1994, 1994, 1998, 1998, 1998, 1998, 1998, 1998, 2002, 2002, 2002, 2002, 2002, 2002, 2006, 2006, 2006, 2006, 2006, 2006, 2008, 2009, 2010, 2010, 2010, 2010, 2010, 2010, 2014, 2014, 2014, 2014, 2014, 2014, 2018, 2018, 2018, 2018, 2018, 2018]",3.5,0.0613688291394023,Low Gender Representation not Detected,0.375,4
24033,25,43,68,"[1994, 1994, 1994, 1994, 1994, 1994, 1994, 1994, 1994, 1998, 1998, 1998, 1998, 1998, 1998, 1998, 1998, 1998, 2002, 2002, 2002, 2002, 2002, 2002, 2002, 2002, 2002, 2004, 2006, 2006, 2006, 2006, 2006, 2006, 2006, 2006, 2006, 2008, 2010, 2010, 2010, 2010, 2010, 2010, 2010, 2010, 2010, 2011, 2014, 2014, 2014, 2014, 2014, 2014, 2014, 2014, 2014, 2018, 2018, 2018, 2018, 2018, 2018, 2018, 2018, 2018, 2018, 2018]",4.764705882352941,0.029049022161940597,Low Gender Representation,0.36764705882352944,4
24037,3,27,30,"[1998, 1998, 1998, 1998, 1998, 2002, 2002, 2002, 2002, 2002, 2006, 2006, 2006, 2006, 2006, 2010, 2010, 2010, 2010, 2010, 2014, 2014, 2014, 2014, 2014, 2018, 2018, 2018, 2018, 2018]",19.2,1.1771339097615006e-05,Low Gender Representation,0.1,1
24043,1,20,21,"[1990, 1990, 1990, 1990, 1990, 1994, 1994, 1994, 1994, 1994, 1998, 1998, 1998, 1998, 1998, 2002, 2006, 2010, 2014, 2015, 2016, 2018]",17.19047619047619,3.381272563301577e-05,Low Gender Representation,0.047619047619047616,0
24045,12,40,52,"[1990, 1990, 1990, 1990, 1990, 1990, 1990, 1990, 1994, 1994, 1994, 1994, 1994, 1994, 1994, 1998, 1998, 1998, 1998, 1998, 1998, 1998, 2002, 2002, 2002, 2002, 2002, 2002, 2006, 2006, 2006, 2006, 2006, 2006, 2010, 2010, 2010, 2010, 2010, 2010, 2014, 2014, 2014, 2014, 2014, 2014, 2018, 2018, 2018, 2018, 2018, 2018, 2020]",15.076923076923077,0.00010321744149513965,Low Gender Representation,0.23076923076923078,2
24047,9,26,35,"[2002, 2002, 2002, 2002, 2002, 2002, 2002, 2006, 2006, 2006, 2006, 2006, 2006, 2006, 2010, 2010, 2010, 2010, 2010, 2010, 2010, 2014, 2014, 2014, 2014, 2014, 2014, 2014, 2018, 2018, 2018, 2018, 2018, 2018, 2018]",8.257142857142858,0.004059196365555051,Low Gender Representation,0.2571428571428571,3
24510,5,20,25,"[2006, 2006, 2006, 2006, 2006, 2006, 2006, 2010, 2010, 2010, 2010, 2010, 2010, 2010, 2014, 2014, 2014, 2014, 2014, 2014, 2014, 2018, 2018, 2018, 2018, 2018, 2018, 2018]",9.0,0.0026997960632601883,Low Gender Representation,0.2,2
25001,4,9,13,"[1990, 1992, 1992, 1994, 1996, 1996, 1998, 2000, 2000, 2002, 2006, 2010, 2014]",1.9230769230769231,0.16551785869746605,Low Gender Representation not Detected,0.3076923076923077,3
25003,0,7,7,"[1990, 1992, 1992, 1994, 1996, 1996, 1998]",7.0,0.008150971593502705,Low Gender Representation,0.0,0
25005,6,7,13,"[1990, 1992, 1992, 1994, 1996, 1996, 1998, 2000, 2000, 2002, 2006, 2010, 2014]",0.07692307692307693,0.7815112949987134,Low Gender Representation not Detected,0.46153846153846156,5
25009,2,5,7,"[1990, 1992, 1992, 1994, 1996, 1996, 1998]",1.2857142857142858,0.2568392579578533,Low Gender Representation not Detected,0.2857142857142857,3
25013,1,5,6,"[1990, 1992, 1992, 1994, 1996, 1996]",2.6666666666666665,0.10247043485974942,Low Gender Representation not Detected,0.16666666666666666,2
25017,0,6,6,"[1990, 1992, 1992, 1994, 1996, 1996]",6.0,0.014305878435429641,Low Gender Representation,0.0,0
25021,0,13,13,"[1990, 1992, 1992, 1994, 1996, 1996, 1998, 2000, 2000, 2002, 2006, 2010, 2014]",13.0,0.0003114909767673841,Low Gender Representation,0.0,0
25023,2,9,11,"[1990, 1994, 1996, 1996, 1998, 2000, 2000, 2002, 2006, 2010, 2014]",4.454545454545454,0.03480847881186725,Low Gender Representation,0.18181818181818182,2
25027,1,5,6,"[1990, 1992, 1992, 1994, 1996, 1996]",2.6666666666666665,0.10247043485974942,Low Gender Representation not Detected,0.16666666666666666,2
26005,0,60,60,"[2006, 2006, 2006, 2006, 2006, 2006, 2006, 2006, 2006, 2006, 2006, 2008, 2008, 2008, 2008, 2008, 2008, 2008, 2008, 2008, 2008, 2008, 2010, 2010, 2010, 2010, 2010, 2010, 2010, 2010, 2010, 2010, 2010, 2012, 2012, 2012, 2012, 2012, 2012, 2012, 2014, 2014, 2014, 2014, 2014, 2014, 2014, 2016, 2016, 2016, 2016, 2016, 2016, 2016, 2018, 2018, 2018, 2018, 2018, 2018, 2018, 2020, 2020, 2020, 2020, 2020, 2020, 2020]",60.0,9.485737571073857e-15,Low Gender Representation,0.0,0
26017,1,33,34,"[2012, 2012, 2012, 2012, 2012, 2012, 2012, 2014, 2014, 2014, 2014, 2014, 2014, 2014, 2016, 2016, 2016, 2016, 2016, 2016, 2016, 2018, 2018, 2018, 2018, 2018, 2018, 2018, 2020, 2020, 2020, 2020, 2020, 2020, 2020]",30.11764705882353,4.0661424565988175e-08,Low Gender Representation,0.029411764705882353,0
26021,39,69,108,"[2004, 2004, 2004, 2004, 2004, 2004, 2004, 2004, 2004, 2004, 2004, 2004, 2004, 2006, 2006, 2006, 2006, 2006, 2006, 2006, 2006, 2006, 2006, 2006, 2006, 2006, 2008, 2008, 2008, 2008, 2008, 2008, 2008, 2008, 2008, 2008, 2008, 2008, 2008, 2010, 2010, 2010, 2010, 2010, 2010, 2010, 2010, 2010, 2010, 2010, 2010, 2010, 2012, 2012, 2012, 2012, 2012, 2012, 2012, 2012, 2012, 2012, 2012, 2012, 2014, 2014, 2014, 2014, 2014, 2014, 2014, 2014, 2014, 2014, 2014, 2014, 2016, 2016, 2016, 2016, 2016, 2016, 2016, 2016, 2016, 2016, 2016, 2016, 2018, 2018, 2018, 2018, 2018, 2018, 2018, 2018, 2018, 2018, 2018, 2018, 2020, 2020, 2020, 2020, 2020, 2020, 2020, 2020, 2020, 2020, 2020, 2020]",8.333333333333334,0.003892417122778637,Low Gender Representation,0.3611111111111111,4
26025,21,70,91,"[1996, 1996, 1996, 1996, 1996, 1996, 1996, 1998, 1998, 1998, 1998, 1998, 1998, 1998, 2000, 2000, 2000, 2000, 2000, 2000, 2000, 2002, 2002, 2002, 2002, 2002, 2002, 2002, 2004, 2004, 2004, 2004, 2004, 2004, 2004, 2006, 2006, 2006, 2006, 2006, 2006, 2006, 2008, 2008, 2008, 2008, 2008, 2008, 2008, 2010, 2010, 2010, 2010, 2010, 2010, 2010, 2012, 2012, 2012, 2012, 2012, 2012, 2012, 2014, 2014, 2014, 2014, 2014, 2014, 2014, 2016, 2016, 2016, 2016, 2016, 2016, 2016, 2018, 2018, 2018, 2018, 2018, 2018, 2018, 2020, 2020, 2020, 2020, 2020, 2020, 2020]",26.384615384615383,2.7975991718067565e-07,Low Gender Representation,0.23076923076923078,2
26037,3,18,21,"[2016, 2016, 2016, 2016, 2016, 2016, 2016, 2018, 2018, 2018, 2018, 2018, 2018, 2018, 2020, 2020, 2020, 2020, 2020, 2020, 2020]",10.714285714285714,0.001063114917158605,Low Gender Representation,0.14285714285714285,1
26045,36,144,180,"[1998, 1998, 1998, 1998, 1998, 1998, 1998, 1998, 1998, 1998, 1998, 1998, 1998, 1998, 1998, 2000, 2000, 2000, 2000, 2000, 2000, 2000, 2000, 2000, 2000, 2000, 2000, 2000, 2000, 2000, 2002, 2002, 2002, 2002, 2002, 2002, 2002, 2002, 2002, 2002, 2002, 2002, 2002, 2002, 2002, 2004, 2004, 2004, 2004, 2004, 2004, 2004, 2004, 2004, 2004, 2004, 2004, 2004, 2004, 2004, 2006, 2006, 2006, 2006, 2006, 2006, 2006, 2006, 2006, 2006, 2006, 2006, 2006, 2006, 2006, 2008, 2008, 2008, 2008, 2008, 2008, 2008, 2008, 2008, 2008, 2008, 2008, 2008, 2008, 2008, 2010, 2010, 2010, 2010, 2010, 2010, 2010, 2010, 2010, 2010, 2010, 2010, 2010, 2010, 2010, 2012, 2012, 2012, 2012, 2012, 2012, 2012, 2012, 2012, 2012, 2012, 2012, 2012, 2012, 2012, 2014, 2014, 2014, 2014, 2014, 2014, 2014, 2014, 2014, 2014, 2014, 2014, 2014, 2014, 2014, 2016, 2016, 2016, 2016, 2016, 2016, 2016, 2016, 2016, 2016, 2016, 2016, 2016, 2016, 2016, 2018, 2018, 2018, 2018, 2018, 2018, 2018, 2018, 2018, 2018, 2018, 2018, 2018, 2018, 2018, 2020, 2020, 2020, 2020, 2020, 2020, 2020, 2020, 2020, 2020, 2020, 2020, 2020, 2020, 2020]",64.8,8.289914674372266e-16,Low Gender Representation,0.2,2
26049,16,47,63,"[2008, 2008, 2008, 2008, 2008, 2008, 2008, 2008, 2008, 2010, 2010, 2010, 2010, 2010, 2010, 2010, 2010, 2010, 2012, 2012, 2012, 2012, 2012, 2012, 2012, 2012, 2012, 2014, 2014, 2014, 2014, 2014, 2014, 2014, 2014, 2014, 2016, 2016, 2016, 2016, 2016, 2016, 2016, 2016, 2016, 2018, 2018, 2018, 2018, 2018, 2018, 2018, 2018, 2018, 2020, 2020, 2020, 2020, 2020, 2020, 2020, 2020, 2020]",15.253968253968255,9.39790952745936e-05,Low Gender Representation,0.25396825396825395,3
26055,7,16,23,"[2012, 2014, 2016, 2016, 2016, 2016, 2016, 2016, 2016, 2018, 2018, 2018, 2018, 2018, 2018, 2018, 2020, 2020, 2020, 2020, 2020, 2020, 2020]",3.5217391304347827,0.060568860202657664,Low Gender Representation not Detected,0.30434782608695654,3
26065,59,109,168,"[1990, 1990, 1990, 1990, 1994, 1998, 1998, 1998, 1998, 1998, 1998, 1998, 1998, 1998, 1998, 1998, 1998, 1998, 2002, 2002, 2002, 2002, 2002, 2002, 2002, 2002, 2002, 2002, 2002, 2002, 2002, 2002, 2002, 2002, 2004, 2004, 2004, 2004, 2004, 2004, 2004, 2004, 2004, 2004, 2004, 2004, 2004, 2004, 2004, 2004, 2006, 2006, 2006, 2006, 2006, 2006, 2006, 2006, 2006, 2006, 2006, 2006, 2006, 2006, 2006, 2006, 2008, 2008, 2008, 2008, 2008, 2008, 2008, 2008, 2008, 2008, 2008, 2008, 2008, 2008, 2008, 2008, 2010, 2010, 2010, 2010, 2010, 2010, 2010, 2010, 2010, 2010, 2010, 2010, 2010, 2010, 2010, 2010, 2012, 2012, 2012, 2012, 2012, 2012, 2012, 2012, 2012, 2012, 2012, 2012, 2012, 2012, 2014, 2014, 2014, 2014, 2014, 2014, 2014, 2014, 2014, 2014, 2014, 2014, 2014, 2014, 2016, 2016, 2016, 2016, 2016, 2016, 2016, 2016, 2016, 2016, 2016, 2016, 2016, 2016, 2018, 2018, 2018, 2018, 2018, 2018, 2018, 2018, 2018, 2018, 2018, 2018, 2018, 2018, 2020, 2020, 2020, 2020, 2020, 2020, 2020, 2020, 2020, 2020, 2020, 2020, 2020, 2020]",14.880952380952381,0.00011451344802160634,Low Gender Representation,0.35119047619047616,4
26075,19,99,118,"[1994, 1994, 1994, 1994, 1994, 1994, 1994, 1994, 1994, 1994, 1994, 1994, 1994, 1996, 1996, 1996, 1996, 1996, 1996, 1996, 1996, 1996, 1996, 1996, 1996, 1996, 1996, 1996, 2000, 2000, 2000, 2000, 2000, 2000, 2000, 2000, 2000, 2000, 2000, 2000, 2000, 2000, 2000, 2006, 2006, 2006, 2006, 2006, 2006, 2006, 2006, 2006, 2006, 2006, 2006, 2008, 2008, 2008, 2008, 2008, 2008, 2008, 2008, 2008, 2010, 2010, 2010, 2010, 2010, 2010, 2010, 2010, 2010, 2012, 2012, 2012, 2012, 2012, 2012, 2012, 2012, 2012, 2014, 2014, 2014, 2014, 2014, 2014, 2014, 2014, 2014, 2016, 2016, 2016, 2016, 2016, 2016, 2016, 2016, 2016, 2018, 2018, 2018, 2018, 2018, 2018, 2018, 2018, 2018, 2020, 2020, 2020, 2020, 2020, 2020, 2020, 2020, 2020]",54.23728813559322,1.7768289192259974e-13,Low Gender Representation,0.16101694915254236,2
26077,26,104,130,"[2002, 2002, 2002, 2002, 2002, 2002, 2002, 2002, 2002, 2002, 2002, 2002, 2002, 2002, 2002, 2002, 2002, 2004, 2004, 2004, 2004, 2004, 2004, 2004, 2004, 2004, 2004, 2004, 2004, 2004, 2004, 2004, 2004, 2004, 2006, 2006, 2006, 2006, 2006, 2006, 2006, 2006, 2006, 2006, 2006, 2006, 2006, 2006, 2006, 2006, 2006, 2008, 2008, 2008, 2008, 2008, 2008, 2008, 2008, 2008, 2008, 2008, 2008, 2008, 2008, 2008, 2008, 2008, 2010, 2010, 2010, 2010, 2010, 2010, 2010, 2010, 2010, 2010, 2010, 2010, 2010, 2010, 2010, 2010, 2010, 2012, 2012, 2012, 2012, 2012, 2012, 2012, 2012, 2012, 2012, 2012, 2014, 2014, 2014, 2014, 2014, 2014, 2014, 2014, 2014, 2014, 2014, 2018, 2018, 2018, 2018, 2018, 2018, 2018, 2018, 2018, 2018, 2018, 2019, 2020, 2020, 2020, 2020, 2020, 2020, 2020, 2020, 2020, 2020, 2020]",46.8,7.861340935384699e-12,Low Gender Representation,0.2,2
26081,54,241,295,"[1990, 1990, 1990, 1990, 1990, 1990, 1990, 1990, 1990, 1990, 1990, 1990, 1990, 1990, 1990, 1990, 1990, 1990, 1990, 1990, 1990, 1992, 1992, 1992, 1992, 1992, 1992, 1992, 1992, 1992, 1992, 1992, 1992, 1992, 1992, 1992, 1992, 1992, 1992, 1992, 1994, 1994, 1994, 1994, 1994, 1994, 1994, 1994, 1994, 1994, 1994, 1994, 1994, 1994, 1994, 1994, 1994, 1994, 1994, 1996, 1996, 1996, 1996, 1996, 1996, 1996, 1996, 1996, 1996, 1996, 1996, 1996, 1996, 1996, 1996, 1996, 1996, 1996, 1998, 1998, 1998, 1998, 1998, 1998, 1998, 1998, 1998, 1998, 1998, 1998, 1998, 1998, 1998, 1998, 1998, 1998, 1998, 2000, 2000, 2000, 2000, 2000, 2000, 2000, 2000, 2000, 2000, 2000, 2000, 2000, 2000, 2000, 2000, 2000, 2000, 2000, 2002, 2002, 2002, 2002, 2002, 2002, 2002, 2002, 2002, 2002, 2002, 2002, 2002, 2002, 2002, 2002, 2002, 2002, 2002, 2004, 2004, 2004, 2004, 2004, 2004, 2004, 2004, 2004, 2004, 2004, 2004, 2004, 2004, 2004, 2004, 2004, 2004, 2004, 2006, 2006, 2006, 2006, 2006, 2006, 2006, 2006, 2006, 2006, 2006, 2006, 2006, 2006, 2006, 2006, 2006, 2006, 2006, 2008, 2008, 2008, 2008, 2008, 2008, 2008, 2008, 2008, 2008, 2008, 2008, 2008, 2008, 2008, 2008, 2008, 2008, 2008, 2010, 2010, 2010, 2010, 2010, 2010, 2010, 2010, 2010, 2010, 2010, 2010, 2010, 2010, 2010, 2010, 2010, 2010, 2010, 2012, 2012, 2012, 2012, 2012, 2012, 2012, 2012, 2012, 2012, 2012, 2012, 2012, 2012, 2012, 2012, 2012, 2012, 2012, 2014, 2014, 2014, 2014, 2014, 2014, 2014, 2014, 2014, 2014, 2014, 2014, 2014, 2014, 2014, 2014, 2014, 2014, 2014, 2016, 2016, 2016, 2016, 2016, 2016, 2016, 2016, 2016, 2016, 2016, 2016, 2016, 2016, 2016, 2016, 2016, 2016, 2016, 2018, 2018, 2018, 2018, 2018, 2018, 2018, 2018, 2018, 2018, 2018, 2018, 2018, 2018, 2018, 2018, 2018, 2018, 2018, 2020, 2020, 2020, 2020, 2020, 2020, 2020, 2020, 2020, 2020, 2020, 2020, 2020, 2020, 2020, 2020, 2020, 2020, 2020]",118.53898305084746,1.3213164871782645e-27,Low Gender Representation,0.18305084745762712,2
26093,23,99,122,"[1990, 1990, 1990, 1990, 1990, 1992, 1992, 1992, 1992, 1992, 1992, 1992, 1992, 1992, 1996, 1996, 1996, 1996, 1996, 1996, 1996, 1996, 1996, 2000, 2000, 2000, 2000, 2000, 2000, 2000, 2000, 2000, 2002, 2002, 2002, 2002, 2002, 2002, 2002, 2002, 2002, 2004, 2004, 2004, 2004, 2004, 2004, 2004, 2004, 2004, 2006, 2006, 2006, 2006, 2006, 2006, 2006, 2006, 2006, 2008, 2008, 2008, 2008, 2008, 2008, 2008, 2008, 2008, 2010, 2010, 2010, 2010, 2010, 2010, 2010, 2010, 2010, 2012, 2012, 2012, 2012, 2012, 2012, 2012, 2012, 2012, 2014, 2014, 2014, 2014, 2014, 2014, 2014, 2014, 2014, 2016, 2016, 2016, 2016, 2016, 2016, 2016, 2016, 2016, 2018, 2018, 2018, 2018, 2018, 2018, 2018, 2018, 2018, 2020, 2020, 2020, 2020, 2020, 2020, 2020, 2020, 2020]",47.34426229508197,5.955217975446605e-12,Low Gender Representation,0.1885245901639344,2
26099,86,177,263,"[1990, 1990, 1990, 1990, 1990, 1990, 1990, 1990, 1990, 1990, 1990, 1992, 1992, 1992, 1992, 1992, 1992, 1992, 1992, 1992, 1992, 1992, 1992, 1992, 1992, 1992, 1992, 1992, 1992, 1992, 1992, 1992, 1992, 1994, 1998, 1998, 1998, 1998, 1998, 1998, 1998, 1998, 1998, 1998, 1998, 1998, 1998, 1998, 1998, 1998, 1998, 1998, 1998, 1998, 1998, 1998, 1998, 1998, 1998, 2000, 2000, 2000, 2000, 2000, 2000, 2000, 2000, 2000, 2000, 2000, 2000, 2000, 2000, 2000, 2000, 2000, 2000, 2000, 2000, 2000, 2000, 2000, 2000, 2000, 2002, 2002, 2002, 2002, 2002, 2002, 2002, 2002, 2002, 2002, 2002, 2002, 2002, 2002, 2002, 2002, 2002, 2002, 2002, 2002, 2002, 2002, 2002, 2002, 2002, 2002, 2004, 2004, 2004, 2004, 2004, 2004, 2004, 2004, 2004, 2004, 2004, 2004, 2004, 2004, 2004, 2004, 2004, 2004, 2004, 2004, 2004, 2004, 2004, 2004, 2004, 2004, 2006, 2006, 2006, 2006, 2006, 2006, 2006, 2006, 2006, 2006, 2006, 2006, 2006, 2006, 2006, 2006, 2006, 2006, 2006, 2006, 2006, 2006, 2006, 2006, 2006, 2006, 2008, 2008, 2008, 2008, 2008, 2008, 2008, 2008, 2008, 2008, 2008, 2008, 2008, 2008, 2008, 2008, 2008, 2008, 2008, 2008, 2008, 2008, 2008, 2008, 2008, 2008, 2010, 2010, 2010, 2010, 2010, 2010, 2010, 2010, 2010, 2010, 2010, 2010, 2010, 2012, 2012, 2012, 2012, 2012, 2012, 2012, 2012, 2012, 2012, 2012, 2012, 2012, 2014, 2014, 2014, 2014, 2014, 2014, 2014, 2014, 2014, 2014, 2014, 2014, 2014, 2016, 2016, 2016, 2016, 2016, 2016, 2016, 2016, 2016, 2016, 2016, 2016, 2016, 2018, 2018, 2018, 2018, 2018, 2018, 2018, 2018, 2018, 2018, 2018, 2018, 2018, 2020, 2020, 2020, 2020, 2020, 2020, 2020, 2020, 2020, 2020, 2020, 2020, 2020]",31.486692015209126,2.0081183643945874e-08,Low Gender Representation,0.3269961977186312,3
26115,3,23,26,"[2014, 2014, 2014, 2014, 2014, 2014, 2014, 2014, 2014, 2018, 2018, 2018, 2018, 2018, 2018, 2018, 2018, 2018, 2020, 2020, 2020, 2020, 2020, 2020, 2020, 2020, 2020]",15.384615384615385,8.769942375590228e-05,Low Gender Representation,0.11538461538461539,1
26121,15,85,100,"[2002, 2002, 2002, 2002, 2002, 2002, 2002, 2002, 2002, 2002, 2002, 2004, 2004, 2004, 2004, 2004, 2004, 2004, 2004, 2004, 2004, 2004, 2006, 2006, 2006, 2006, 2006, 2006, 2006, 2006, 2006, 2006, 2006, 2008, 2008, 2008, 2008, 2008, 2008, 2008, 2008, 2008, 2008, 2008, 2010, 2010, 2010, 2010, 2010, 2010, 2010, 2010, 2010, 2010, 2010, 2012, 2012, 2012, 2012, 2012, 2012, 2012, 2012, 2012, 2014, 2014, 2014, 2014, 2014, 2014, 2014, 2014, 2014, 2016, 2016, 2016, 2016, 2016, 2016, 2016, 2016, 2016, 2018, 2018, 2018, 2018, 2018, 2018, 2018, 2018, 2018, 2020, 2020, 2020, 2020, 2020, 2020, 2020, 2020, 2020]",49.0,2.559625087771672e-12,Low Gender Representation,0.15,2
26125,89,162,251,"[1992, 1992, 1992, 1992, 1992, 1992, 1992, 1992, 1992, 1992, 1992, 1992, 1992, 1992, 1992, 1992, 1992, 1992, 1992, 1992, 1992, 1992, 1992, 1996, 1996, 1996, 1996, 1996, 1996, 1996, 1996, 1996, 1996, 1996, 1996, 1996, 1996, 1996, 1996, 1996, 1996, 1996, 1996, 1996, 1996, 1996, 1996, 2004, 2004, 2004, 2004, 2004, 2004, 2004, 2004, 2004, 2004, 2004, 2004, 2004, 2004, 2004, 2004, 2004, 2004, 2004, 2004, 2004, 2004, 2004, 2004, 2004, 2006, 2006, 2006, 2006, 2006, 2006, 2006, 2006, 2006, 2006, 2006, 2006, 2006, 2006, 2006, 2006, 2006, 2006, 2006, 2006, 2006, 2006, 2006, 2006, 2006, 2008, 2008, 2008, 2008, 2008, 2008, 2008, 2008, 2008, 2008, 2008, 2008, 2008, 2008, 2008, 2008, 2008, 2008, 2008, 2008, 2008, 2008, 2008, 2008, 2008, 2010, 2010, 2010, 2010, 2010, 2010, 2010, 2010, 2010, 2010, 2010, 2010, 2010, 2010, 2010, 2010, 2010, 2010, 2010, 2010, 2010, 2010, 2010, 2010, 2010, 2012, 2012, 2012, 2012, 2012, 2012, 2012, 2012, 2012, 2012, 2012, 2012, 2012, 2012, 2012, 2012, 2012, 2012, 2012, 2012, 2012, 2014, 2014, 2014, 2014, 2014, 2014, 2014, 2014, 2014, 2014, 2014, 2014, 2014, 2014, 2014, 2014, 2014, 2014, 2014, 2014, 2014, 2016, 2016, 2016, 2016, 2016, 2016, 2016, 2016, 2016, 2016, 2016, 2016, 2016, 2016, 2016, 2016, 2016, 2016, 2016, 2016, 2016, 2018, 2018, 2018, 2018, 2018, 2018, 2018, 2018, 2018, 2018, 2018, 2018, 2018, 2018, 2018, 2018, 2018, 2018, 2018, 2018, 2018, 2020, 2020, 2020, 2020, 2020, 2020, 2020, 2020, 2020, 2020, 2020, 2020, 2020, 2020, 2020, 2020, 2020, 2020, 2020, 2020, 2020]",21.231075697211157,4.071100467633155e-06,Low Gender Representation,0.3545816733067729,4
26139,15,168,183,"[1990, 1990, 1990, 1990, 1990, 1990, 1990, 1990, 1990, 1992, 1992, 1992, 1992, 1992, 1992, 1992, 1992, 1992, 1992, 1992, 1992, 1992, 1994, 1994, 1994, 1994, 1994, 1994, 1994, 1994, 1994, 1994, 1994, 1994, 1994, 1996, 1996, 1996, 1996, 1996, 1996, 1996, 1996, 1996, 1996, 1996, 1996, 1996, 1998, 1998, 1998, 1998, 1998, 1998, 1998, 1998, 1998, 1998, 1998, 1998, 1998, 2000, 2000, 2000, 2000, 2000, 2000, 2000, 2000, 2000, 2000, 2000, 2000, 2000, 2002, 2002, 2002, 2002, 2002, 2002, 2002, 2002, 2002, 2002, 2002, 2004, 2004, 2004, 2004, 2004, 2004, 2004, 2004, 2004, 2004, 2004, 2006, 2006, 2006, 2006, 2006, 2006, 2006, 2006, 2006, 2006, 2006, 2008, 2008, 2008, 2008, 2008, 2008, 2008, 2008, 2008, 2008, 2008, 2010, 2010, 2010, 2010, 2010, 2010, 2010, 2010, 2010, 2010, 2010, 2012, 2012, 2012, 2012, 2012, 2012, 2012, 2012, 2012, 2012, 2012, 2014, 2014, 2014, 2014, 2014, 2014, 2014, 2014, 2014, 2014, 2014, 2016, 2016, 2016, 2016, 2016, 2016, 2016, 2016, 2016, 2016, 2016, 2018, 2018, 2018, 2018, 2018, 2018, 2018, 2018, 2018, 2018, 2018, 2020, 2020, 2020, 2020, 2020, 2020, 2020, 2020, 2020, 2020, 2020]",127.91803278688525,1.1697555537416099e-29,Low Gender Representation,0.08196721311475409,1
26145,35,181,216,"[1990, 1990, 1990, 1990, 1990, 1990, 1990, 1990, 1990, 1990, 1990, 1990, 1990, 1990, 1990, 1992, 1992, 1992, 1992, 1992, 1992, 1992, 1992, 1992, 1992, 1992, 1992, 1992, 1992, 1992, 1994, 1994, 1994, 1994, 1994, 1994, 1994, 1994, 1994, 1994, 1994, 1994, 1994, 1994, 1994, 1996, 1996, 1996, 1996, 1996, 1996, 1996, 1996, 1996, 1996, 1996, 1996, 1996, 1996, 1996, 1998, 1998, 1998, 1998, 1998, 1998, 1998, 1998, 1998, 1998, 1998, 1998, 1998, 1998, 1998, 2000, 2000, 2000, 2000, 2000, 2000, 2000, 2000, 2000, 2000, 2000, 2000, 2000, 2000, 2000, 2002, 2002, 2002, 2002, 2002, 2002, 2002, 2002, 2002, 2002, 2002, 2002, 2002, 2002, 2002, 2004, 2004, 2004, 2004, 2004, 2004, 2004, 2004, 2004, 2004, 2004, 2004, 2004, 2004, 2004, 2006, 2006, 2006, 2006, 2006, 2006, 2006, 2006, 2006, 2006, 2006, 2006, 2006, 2006, 2006, 2008, 2008, 2008, 2008, 2008, 2008, 2008, 2008, 2008, 2008, 2008, 2008, 2008, 2008, 2008, 2010, 2010, 2010, 2010, 2010, 2010, 2010, 2010, 2010, 2010, 2010, 2010, 2010, 2010, 2010, 2012, 2012, 2012, 2012, 2012, 2012, 2012, 2012, 2012, 2012, 2012, 2014, 2014, 2014, 2014, 2014, 2014, 2014, 2014, 2014, 2014, 2014, 2016, 2016, 2016, 2016, 2016, 2016, 2016, 2016, 2016, 2016, 2016, 2018, 2018, 2018, 2018, 2018, 2018, 2018, 2018, 2018, 2018, 2018, 2020, 2020, 2020, 2020, 2020, 2020, 2020, 2020, 2020, 2020, 2020]",98.68518518518519,2.9600828793634373e-23,Low Gender Representation,0.16203703703703703,2
26147,23,73,96,"[1994, 1994, 1994, 1994, 1994, 1994, 1996, 1996, 1996, 1996, 1996, 1996, 1996, 1998, 1998, 1998, 1998, 1998, 1998, 1998, 2000, 2000, 2000, 2000, 2000, 2000, 2000, 2002, 2002, 2002, 2002, 2002, 2002, 2002, 2004, 2004, 2004, 2004, 2004, 2004, 2004, 2006, 2006, 2006, 2006, 2006, 2006, 2006, 2008, 2008, 2008, 2008, 2008, 2008, 2008, 2010, 2010, 2010, 2010, 2010, 2010, 2010, 2012, 2012, 2012, 2012, 2012, 2012, 2012, 2014, 2014, 2014, 2014, 2014, 2014, 2014, 2016, 2016, 2016, 2016, 2016, 2016, 2016, 2018, 2018, 2018, 2018, 2018, 2018, 2018, 2020, 2020, 2020, 2020, 2020, 2020, 2020]",26.041666666666668,3.3412791127020217e-07,Low Gender Representation,0.23958333333333334,2
26161,69,115,184,"[1990, 1990, 1990, 1990, 1990, 1990, 1990, 1990, 1990, 1992, 1992, 1992, 1992, 1992, 1992, 1992, 1992, 1992, 1992, 1992, 1992, 1992, 1992, 1992, 1994, 1994, 1994, 1994, 1994, 1994, 1994, 1994, 1994, 1994, 1994, 1994, 1994, 1994, 1994, 1996, 1996, 1996, 1996, 1996, 1996, 1996, 1996, 1996, 1996, 1996, 1996, 1996, 1996, 1996, 1998, 1998, 1998, 1998, 1998, 1998, 1998, 1998, 1998, 1998, 1998, 1998, 1998, 1998, 1998, 2000, 2000, 2000, 2000, 2000, 2000, 2000, 2000, 2000, 2000, 2000, 2000, 2000, 2000, 2000, 2002, 2002, 2002, 2002, 2002, 2002, 2002, 2002, 2002, 2002, 2002, 2004, 2004, 2004, 2004, 2004, 2004, 2004, 2004, 2004, 2004, 2004, 2006, 2006, 2006, 2006, 2006, 2006, 2006, 2006, 2006, 2006, 2006, 2008, 2008, 2008, 2008, 2008, 2008, 2008, 2008, 2008, 2008, 2008, 2010, 2010, 2010, 2010, 2010, 2010, 2010, 2010, 2010, 2010, 2010, 2012, 2012, 2012, 2012, 2012, 2012, 2012, 2012, 2012, 2014, 2014, 2014, 2014, 2014, 2014, 2014, 2014, 2014, 2016, 2016, 2016, 2016, 2016, 2016, 2016, 2016, 2016, 2018, 2018, 2018, 2018, 2018, 2018, 2018, 2018, 2018, 2020, 2020, 2020, 2020, 2020, 2020, 2020, 2020, 2020]",11.5,0.0006959618992743264,Low Gender Representation,0.375,4
26163,98,144,242,"[1990, 1990, 1990, 1990, 1990, 1990, 1990, 1990, 1990, 1990, 1990, 1990, 1990, 1990, 1990, 1992, 1992, 1992, 1992, 1992, 1992, 1992, 1992, 1992, 1992, 1992, 1992, 1992, 1992, 1992, 1994, 1994, 1994, 1994, 1994, 1994, 1994, 1994, 1994, 1994, 1994, 1994, 1994, 1994, 1994, 1996, 1996, 1996, 1996, 1996, 1996, 1996, 1996, 1996, 1996, 1996, 1996, 1996, 1996, 1996, 1998, 1998, 1998, 1998, 1998, 1998, 1998, 1998, 1998, 1998, 1998, 1998, 1998, 1998, 1998, 2000, 2000, 2000, 2000, 2000, 2000, 2000, 2000, 2000, 2000, 2000, 2000, 2000, 2000, 2000, 2002, 2002, 2002, 2002, 2002, 2002, 2002, 2002, 2002, 2002, 2002, 2002, 2002, 2002, 2002, 2004, 2004, 2004, 2004, 2004, 2004, 2004, 2004, 2004, 2004, 2004, 2004, 2004, 2004, 2004, 2006, 2006, 2006, 2006, 2006, 2006, 2006, 2006, 2006, 2006, 2006, 2006, 2006, 2006, 2006, 2008, 2008, 2008, 2008, 2008, 2008, 2008, 2008, 2008, 2008, 2008, 2008, 2008, 2008, 2008, 2010, 2010, 2010, 2010, 2010, 2010, 2010, 2010, 2010, 2010, 2010, 2010, 2010, 2010, 2010, 2012, 2012, 2012, 2012, 2012, 2012, 2012, 2012, 2012, 2012, 2012, 2012, 2012, 2012, 2012, 2014, 2014, 2014, 2014, 2014, 2014, 2014, 2014, 2014, 2014, 2014, 2014, 2014, 2014, 2014, 2016, 2016, 2016, 2016, 2016, 2016, 2016, 2016, 2016, 2016, 2016, 2016, 2016, 2016, 2016, 2018, 2018, 2018, 2018, 2018, 2018, 2018, 2018, 2018, 2018, 2018, 2018, 2018, 2018, 2018, 2018, 2020, 2020, 2020, 2020, 2020, 2020, 2020, 2020, 2020, 2020, 2020, 2020, 2020, 2020, 2020, 2021]",8.743801652892563,0.0031065618383903943,Low Gender Representation,0.4049586776859504,4
27003,6,10,16,"[2004, 2008, 2014, 2014, 2014, 2016, 2016, 2016, 2016, 2018, 2018, 2018, 2020, 2020, 2020, 2020]",1.0,0.31731050786291115,Low Gender Representation not Detected,0.375,4
27019,2,4,6,"[2016, 2016, 2016, 2020, 2020, 2020]",0.6666666666666666,0.4142161782425251,Low Gender Representation not Detected,0.3333333333333333,3
27037,8,6,14,"[2014, 2014, 2014, 2016, 2016, 2016, 2016, 2018, 2018, 2018, 2020, 2020, 2020, 2020]",0.2857142857142857,0.5929800980174267,Low Gender Representation not Detected,0.5714285714285714,6
27053,19,23,42,"[1994, 2002, 2002, 2002, 2002, 2002, 2002, 2002, 2004, 2004, 2004, 2006, 2006, 2006, 2006, 2008, 2008, 2008, 2010, 2010, 2010, 2010, 2012, 2012, 2012, 2012, 2012, 2014, 2014, 2014, 2014, 2016, 2016, 2016, 2016, 2018, 2018, 2018, 2020, 2020, 2020, 2020]",0.38095238095238093,0.5370939784426414,Low Gender Representation not Detected,0.4523809523809524,5
27109,4,10,14,"[2014, 2014, 2014, 2016, 2016, 2016, 2016, 2018, 2018, 2018, 2020, 2020, 2020, 2020]",2.5714285714285716,0.10880943004054605,Low Gender Representation not Detected,0.2857142857142857,3
27123,12,6,18,"[2012, 2012, 2012, 2014, 2014, 2014, 2014, 2016, 2016, 2016, 2018, 2018, 2018, 2018, 2019, 2020, 2020, 2020]",2.0,0.15729920705028105,Low Gender Representation not Detected,0.6666666666666666,7
27137,2,15,17,"[2012, 2014, 2014, 2014, 2014, 2016, 2016, 2016, 2016, 2018, 2018, 2018, 2019, 2020, 2020, 2020, 2020]",9.941176470588236,0.0016162222150599877,Low Gender Representation,0.11764705882352941,1
27139,2,6,8,"[2016, 2016, 2016, 2018, 2018, 2020, 2020, 2020]",2.0,0.15729920705028105,Low Gender Representation not Detected,0.25,2
27141,5,5,10,"[2014, 2014, 2016, 2016, 2016, 2018, 2018, 2020, 2020, 2020]",0.0,1.0,Low Gender Representation not Detected,0.5,5
27145,1,9,10,"[2014, 2014, 2016, 2016, 2016, 2018, 2018, 2020, 2020, 2020]",6.4,0.01141203638600166,Low Gender Representation,0.1,1
27163,3,9,12,"[2014, 2014, 2016, 2016, 2016, 2016, 2018, 2018, 2020, 2020, 2020, 2020]",3.0,0.08326451666355042,Low Gender Representation not Detected,0.25,2
27171,3,7,10,"[2014, 2014, 2016, 2016, 2016, 2018, 2018, 2020, 2020, 2020]",1.6,0.20590321073206466,Low Gender Representation not Detected,0.3,3
29019,7,11,18,"[1998, 2000, 2000, 2002, 2004, 2004, 2006, 2008, 2008, 2010, 2012, 2012, 2012, 2014, 2016, 2016, 2020, 2020]",0.8888888888888888,0.3457785861511601,Low Gender Representation not Detected,0.3888888888888889,4
29037,0,4,4,"[2012, 2012, 2012, 2014]",4.0,0.04550026389635857,Low Gender Representation,0.0,0
29047,4,6,10,"[2008, 2008, 2010, 2012, 2012, 2014, 2016, 2016, 2020, 2020]",0.4,0.5270892568655381,Low Gender Representation not Detected,0.4,4
29071,0,8,8,"[2010, 2012, 2012, 2014, 2016, 2016, 2020, 2020]",8.0,0.004677734981047276,Low Gender Representation,0.0,0
29077,3,21,24,"[1990, 1990, 1990, 1992, 1992, 1994, 1994, 1994, 1996, 1996, 1998, 2000, 2000, 2002, 2004, 2004, 2008, 2008, 2012, 2012, 2014, 2016, 2016, 2020, 2020]",13.5,0.00023856345402870974,Low Gender Representation,0.125,1
29099,8,33,41,"[1990, 1990, 1990, 1992, 1992, 1994, 1994, 1994, 1996, 1996, 1998, 2000, 2000, 2002, 2006, 2008, 2008, 2010, 2010, 2010, 2010, 2010, 2010, 2010, 2012, 2012, 2012, 2014, 2014, 2014, 2014, 2016, 2016, 2016, 2018, 2018, 2018, 2018, 2020, 2020, 2020]",15.24390243902439,9.44812939149016e-05,Low Gender Representation,0.1951219512195122,2
29183,8,46,54,"[1990, 1990, 1990, 1992, 1992, 1992, 1992, 1992, 1992, 1992, 1998, 1998, 1998, 1998, 2000, 2000, 2000, 2001, 2001, 2002, 2002, 2002, 2002, 2006, 2006, 2006, 2006, 2006, 2007, 2008, 2008, 2008, 2008, 2010, 2010, 2010, 2010, 2012, 2012, 2012, 2014, 2014, 2014, 2014, 2016, 2016, 2016, 2018, 2018, 2018, 2018, 2020, 2020, 2020]",26.74074074074074,2.3266392076021818e-07,Low Gender Representation,0.14814814814814814,1
29189,23,33,56,"[1990, 1990, 1996, 1996, 1996, 1997, 1998, 1998, 1998, 1998, 2000, 2000, 2000, 2002, 2002, 2002, 2002, 2002, 2002, 2004, 2004, 2004, 2004, 2006, 2006, 2006, 2006, 2008, 2008, 2008, 2010, 2010, 2010, 2010, 2012, 2012, 2012, 2014, 2014, 2014, 2014, 2014, 2015, 2016, 2016, 2016, 2018, 2018, 2018, 2018, 2019, 2019, 2020, 2020, 2020, 2020]",1.7857142857142858,0.18144920772141646,Low Gender Representation not Detected,0.4107142857142857,4
29510,15,15,30,"[2017, 2017, 2017, 2017, 2017, 2017, 2017, 2017, 2017, 2017, 2017, 2017, 2017, 2017, 2017, 2017, 2019, 2019, 2019, 2019, 2019, 2019, 2019, 2019, 2019, 2019, 2019, 2019, 2019, 2019]",0.0,1.0,Low Gender Representation not Detected,0.5,5
30063,1,2,3,"[2016, 2018, 2020]",0.3333333333333333,0.5637028616507731,Low Gender Representation not Detected,0.3333333333333333,3
30111,0,3,3,"[2016, 2018, 2020]",3.0,0.08326451666355042,Low Gender Representation not Detected,0.0,0
31055,15,32,47,"[1994, 1994, 1994, 1996, 1996, 1996, 1996, 1998, 1998, 1998, 2000, 2002, 2002, 2002, 2004, 2004, 2004, 2004, 2006, 2006, 2006, 2008, 2008, 2008, 2008, 2010, 2010, 2010, 2012, 2012, 2012, 2012, 2014, 2014, 2014, 2016, 2016, 2016, 2016, 2018, 2018, 2018, 2020, 2020, 2020, 2020, 2021]",6.148936170212766,0.013149117330897023,Low Gender Representation,0.3191489361702128,3
31109,5,2,7,"[2016, 2016, 2018, 2018, 2018, 2020, 2020]",1.2857142857142858,0.2568392579578533,Low Gender Representation not Detected,0.7142857142857143,7
31153,1,7,8,"[2016, 2016, 2016, 2018, 2018, 2020, 2020, 2020]",4.5,0.033894853524689295,Low Gender Representation,0.125,1
32003,25,35,60,"[1990, 1990, 1990, 1992, 1992, 1992, 1992, 1994, 1994, 1994, 1996, 1996, 1996, 1996, 1998, 1998, 1998, 2000, 2000, 2000, 2000, 2002, 2002, 2002, 2004, 2004, 2004, 2004, 2004, 2006, 2006, 2006, 2008, 2008, 2008, 2008, 2010, 2010, 2010, 2012, 2012, 2012, 2012, 2014, 2014, 2014, 2016, 2016, 2016, 2016, 2016, 2017, 2018, 2018, 2018, 2019, 2020, 2020, 2020, 2020]",1.6666666666666667,0.1967056024589432,Low Gender Representation not Detected,0.4166666666666667,4
32031,15,26,41,"[1990, 1990, 1990, 1992, 1992, 1994, 1994, 1994, 1996, 1996, 1998, 1998, 1998, 2000, 2000, 2002, 2002, 2002, 2004, 2004, 2006, 2006, 2006, 2008, 2008, 2008, 2010, 2010, 2010, 2012, 2012, 2014, 2014, 2014, 2016, 2016, 2018, 2018, 2018, 2020, 2020]",2.951219512195122,0.08581278065055244,Low Gender Representation not Detected,0.36585365853658536,4
33011,11,6,17,"[2000, 2002, 2004, 2006, 2008, 2010, 2012, 2014, 2016, 2016, 2016, 2018, 2018, 2018, 2020, 2020, 2020]",1.4705882352941178,0.22525290636064965,Low Gender Representation not Detected,0.6470588235294118,6
33013,1,1,2,"[2020, 2020]",0.0,1.0,Low Gender Representation not Detected,0.5,5
33017,0,3,3,"[2020, 2020, 2020]",3.0,0.08326451666355042,Low Gender Representation not Detected,0.0,0
34001,9,42,51,"[1997, 1997, 1997, 1998, 1998, 1998, 1999, 1999, 1999, 2000, 2000, 2000, 2001, 2001, 2002, 2002, 2002, 2003, 2003, 2003, 2004, 2004, 2004, 2005, 2005, 2005, 2006, 2006, 2006, 2007, 2007, 2007, 2008, 2008, 2008, 2009, 2009, 2009, 2010, 2010, 2010, 2016, 2016, 2016, 2017, 2017, 2018, 2018, 2018, 2020, 2020]",21.352941176470587,3.820342059747449e-06,Low Gender Representation,0.17647058823529413,2
34003,15,28,43,"[1991, 1991, 1991, 1994, 1996, 1996, 1997, 1997, 1998, 1998, 1998, 1999, 1999, 2000, 2000, 2001, 2001, 2001, 2002, 2002, 2003, 2003, 2003, 2003, 2004, 2005, 2006, 2007, 2008, 2009, 2010, 2011, 2012, 2013, 2014, 2015, 2015, 2016, 2017, 2018, 2019, 2020, 2020, 2021]",3.9302325581395348,0.04742538550874104,Low Gender Representation,0.3488372093023256,3
34005,15,28,43,"[1990, 1990, 1991, 1991, 1992, 1993, 1993, 1994, 1994, 1995, 1996, 1996, 1997, 1997, 1998, 1999, 1999, 2000, 2000, 2001, 2003, 2004, 2005, 2006, 2007, 2008, 2009, 2010, 2010, 2011, 2012, 2013, 2014, 2015, 2016, 2017, 2018, 2019, 2019, 2019, 2020, 2020, 2021]",3.9302325581395348,0.04742538550874104,Low Gender Representation,0.3488372093023256,3
34007,9,37,46,"[1990, 1990, 1991, 1991, 1991, 1992, 1992, 1993, 1993, 1994, 1994, 1994, 1995, 1995, 1996, 1996, 1996, 1997, 1997, 1997, 1998, 1998, 1999, 1999, 2002, 2003, 2004, 2005, 2006, 2007, 2008, 2009, 2010, 2011, 2012, 2013, 2014, 2015, 2015, 2016, 2017, 2018, 2019, 2019, 2020, 2020, 2020, 2020, 2021]",17.043478260869566,3.65336316503404e-05,Low Gender Representation,0.1956521739130435,2
34009,1,21,22,"[1994, 1997, 2000, 2003, 2004, 2005, 2006, 2007, 2008, 2009, 2010, 2011, 2012, 2013, 2014, 2015, 2016, 2017, 2018, 2019, 2020, 2021]",18.181818181818183,2.007865612426481e-05,Low Gender Representation,0.045454545454545456,0
34011,12,35,47,"[2003, 2003, 2004, 2004, 2005, 2005, 2005, 2006, 2006, 2007, 2007, 2008, 2008, 2008, 2009, 2009, 2010, 2010, 2011, 2011, 2011, 2011, 2011, 2012, 2012, 2013, 2013, 2014, 2014, 2014, 2015, 2015, 2016, 2016, 2017, 2017, 2017, 2018, 2018, 2019, 2019, 2020, 2020, 2020, 2020, 2021, 2021]",11.25531914893617,0.0007939517007830229,Low Gender Representation,0.2553191489361702,3
34013,16,40,56,"[1999, 1999, 1999, 1999, 1999, 2002, 2002, 2002, 2002, 2002, 2003, 2004, 2005, 2005, 2005, 2005, 2005, 2005, 2008, 2008, 2008, 2008, 2008, 2008, 2011, 2011, 2011, 2011, 2011, 2011, 2012, 2013, 2014, 2014, 2014, 2014, 2014, 2014, 2017, 2017, 2017, 2017, 2017, 2017, 2017, 2018, 2019, 2020, 2020, 2020, 2020, 2020, 2020, 2020, 2020, 2020]",10.285714285714286,0.0013406411172294807,Low Gender Representation,0.2857142857142857,3
34015,5,44,49,"[1990, 1990, 1990, 1991, 1991, 1992, 1992, 1993, 1993, 1993, 1994, 1994, 1995, 1995, 1996, 1996, 1996, 1997, 1997, 1998, 1999, 1999, 1999, 2000, 2000, 2001, 2001, 2003, 2004, 2006, 2007, 2008, 2009, 2010, 2011, 2012, 2013, 2014, 2015, 2015, 2016, 2017, 2018, 2019, 2020, 2020, 2020, 2020, 2021]",31.040816326530614,2.5265895043266406e-08,Low Gender Representation,0.10204081632653061,1
34017,8,49,57,"[2004, 2004, 2005, 2005, 2005, 2005, 2005, 2005, 2005, 2005, 2005, 2007, 2008, 2008, 2008, 2008, 2008, 2008, 2008, 2008, 2008, 2011, 2011, 2011, 2011, 2011, 2011, 2011, 2011, 2011, 2014, 2014, 2014, 2014, 2014, 2014, 2014, 2014, 2014, 2017, 2017, 2017, 2017, 2017, 2017, 2017, 2017, 2017, 2020, 2020, 2020, 2020, 2020, 2020, 2020, 2020, 2020, 2020]",29.49122807017544,5.617035300382033e-08,Low Gender Representation,0.14035087719298245,1
34019,0,1,1,[2020],1.0,0.31731050786291115,Low Gender Representation not Detected,0.0,0
34021,11,29,40,"[1989, 1989, 1990, 1990, 1991, 1991, 1991, 1992, 1992, 1992, 1992, 1993, 1993, 1994, 1994, 1994, 1994, 1995, 1995, 1996, 1996, 1997, 1997, 1997, 1998, 1998, 1999, 1999, 2000, 2000, 2000, 2001, 2001, 2002, 2002, 2003, 2003, 2003, 2020, 2020]",8.1,0.004426525857919834,Low Gender Representation,0.275,3
34023,13,34,47,"[1991, 1991, 1992, 1992, 1992, 1993, 1993, 1994, 1994, 1995, 1995, 1995, 1996, 1996, 1997, 1997, 1998, 1998, 1998, 1999, 1999, 2000, 2000, 2001, 2001, 2001, 2002, 2003, 2004, 2005, 2006, 2007, 2008, 2009, 2009, 2010, 2011, 2012, 2013, 2014, 2015, 2016, 2017, 2017, 2018, 2019, 2020, 2021, 2021]",9.382978723404255,0.0021900939649289884,Low Gender Representation,0.2765957446808511,3
34025,15,30,45,"[1989, 1989, 1990, 1990, 1991, 1992, 1992, 1993, 1993, 1994, 1995, 1995, 1996, 1996, 1997, 1998, 1998, 1999, 1999, 2000, 2000, 2001, 2002, 2003, 2004, 2005, 2006, 2007, 2008, 2009, 2010, 2011, 2012, 2012, 2013, 2014, 2015, 2016, 2017, 2018, 2018, 2019, 2020, 2020, 2021]",5.0,0.025347318677468325,Low Gender Representation,0.3333333333333333,3
34027,11,13,24,"[1994, 1994, 1999, 2002, 2003, 2004, 2005, 2006, 2007, 2008, 2009, 2010, 2011, 2012, 2012, 2012, 2013, 2014, 2015, 2016, 2017, 2018, 2019, 2020, 2020, 2021]",0.16666666666666666,0.6830913983096086,Low Gender Representation not Detected,0.4583333333333333,5
34029,1,40,41,"[1990, 1991, 1991, 1992, 1992, 1993, 1994, 1994, 1995, 1995, 1996, 1997, 1997, 1998, 1998, 1999, 2000, 2000, 2001, 2001, 2002, 2003, 2003, 2004, 2004, 2006, 2007, 2008, 2009, 2010, 2011, 2012, 2013, 2014, 2015, 2016, 2017, 2018, 2019, 2020, 2021]",37.09756097560975,1.1236418084450895e-09,Low Gender Representation,0.024390243902439025,0
34031,11,28,39,"[1996, 1996, 1997, 1997, 1997, 1998, 1998, 1999, 1999, 2000, 2000, 2000, 2001, 2001, 2002, 2002, 2003, 2004, 2005, 2006, 2007, 2008, 2009, 2010, 2011, 2012, 2013, 2014, 2015, 2016, 2016, 2017, 2017, 2017, 2018, 2019, 2020, 2020, 2021]",7.410256410256411,0.00648530797067137,Low Gender Representation,0.28205128205128205,3
34033,7,14,21,"[2003, 2004, 2005, 2006, 2007, 2008, 2009, 2010, 2011, 2012, 2013, 2014, 2015, 2016, 2017, 2017, 2017, 2018, 2019, 2020, 2021]",2.3333333333333335,0.12663045794761726,Low Gender Representation not Detected,0.3333333333333333,3
34035,9,19,28,"[1990, 1990, 1991, 1991, 1991, 1994, 1994, 2000, 2003, 2004, 2005, 2006, 2007, 2008, 2009, 2010, 2011, 2012, 2013, 2014, 2015, 2016, 2017, 2018, 2019, 2020, 2020, 2021]",3.5714285714285716,0.05878172135535891,Low Gender Representation not Detected,0.32142857142857145,3
34037,6,28,34,"[1989, 1990, 1993, 1996, 1997, 1997, 1998, 1999, 2000, 2001, 2002, 2002, 2003, 2004, 2005, 2006, 2007, 2008, 2009, 2010, 2011, 2012, 2013, 2013, 2014, 2015, 2016, 2017, 2018, 2019, 2020, 2020, 2021, 2021]",14.235294117647058,0.0001613164203086201,Low Gender Representation,0.17647058823529413,2
34039,19,36,55,"[1991, 1991, 1991, 1992, 1992, 1992, 1993, 1993, 1993, 1994, 1994, 1994, 1995, 1995, 1995, 1996, 1996, 1996, 1997, 1997, 1997, 1998, 1998, 1998, 1999, 1999, 1999, 2000, 2000, 2000, 2001, 2001, 2001, 2003, 2004, 2006, 2007, 2008, 2009, 2010, 2011, 2012, 2013, 2014, 2015, 2016, 2017, 2018, 2018, 2019, 2020, 2020, 2020, 2020, 2021]",5.254545454545455,0.02188951812056614,Low Gender Representation,0.34545454545454546,3
34041,1,22,23,"[1999, 2000, 2002, 2003, 2004, 2005, 2006, 2007, 2008, 2009, 2009, 2010, 2011, 2012, 2013, 2014, 2015, 2016, 2017, 2018, 2019, 2020, 2021]",19.17391304347826,1.193331081541827e-05,Low Gender Representation,0.043478260869565216,0
35001,16,27,43,"[1990, 1990, 1992, 1992, 1992, 1994, 1994, 1996, 1996, 1996, 1998, 1998, 2000, 2000, 2000, 2002, 2002, 2004, 2004, 2004, 2006, 2006, 2008, 2008, 2008, 2010, 2010, 2010, 2012, 2012, 2012, 2012, 2014, 2014, 2016, 2016, 2016, 2018, 2018, 2020, 2020, 2020, 2020]",2.813953488372093,0.09344782215861407,Low Gender Representation not Detected,0.37209302325581395,4
35005,6,23,29,"[1998, 1998, 2000, 2000, 2000, 2002, 2002, 2002, 2004, 2004, 2004, 2006, 2006, 2008, 2008, 2008, 2010, 2010, 2012, 2012, 2012, 2014, 2014, 2016, 2016, 2016, 2018, 2018, 2020, 2020, 2020]",9.96551724137931,0.0015949936169505198,Low Gender Representation,0.20689655172413793,2
35013,5,8,13,"[2010, 2010, 2014, 2014, 2016, 2016, 2016, 2018, 2018, 2018, 2020, 2020, 2020]",0.6923076923076923,0.40538055645894244,Low Gender Representation not Detected,0.38461538461538464,4
35025,3,28,31,"[1998, 1998, 2000, 2000, 2000, 2002, 2002, 2004, 2004, 2004, 2006, 2006, 2008, 2008, 2008, 2010, 2010, 2012, 2012, 2012, 2014, 2014, 2014, 2016, 2016, 2016, 2018, 2018, 2020, 2020, 2020]",20.161290322580644,7.117886553922736e-06,Low Gender Representation,0.0967741935483871,1
35031,4,15,19,"[1998, 1998, 2000, 2002, 2002, 2004, 2006, 2006, 2008, 2010, 2010, 2012, 2014, 2014, 2014, 2016, 2018, 2018, 2020]",6.368421052631579,0.011616891434158384,Low Gender Representation,0.21052631578947367,2
35035,7,10,17,"[1998, 1998, 2000, 2002, 2002, 2004, 2006, 2006, 2008, 2010, 2010, 2012, 2014, 2014, 2016, 2018, 2018, 2020]",0.5294117647058824,0.46685427082272524,Low Gender Representation not Detected,0.4117647058823529,4
35043,4,26,30,"[1998, 1998, 2000, 2000, 2000, 2002, 2002, 2004, 2004, 2004, 2006, 2006, 2008, 2008, 2008, 2010, 2010, 2012, 2012, 2012, 2014, 2014, 2016, 2016, 2016, 2018, 2018, 2020, 2020, 2020]",16.133333333333333,5.903578049588006e-05,Low Gender Representation,0.13333333333333333,1
35045,6,24,30,"[1998, 1998, 2000, 2000, 2000, 2002, 2002, 2004, 2004, 2004, 2006, 2006, 2008, 2008, 2008, 2010, 2010, 2012, 2012, 2012, 2014, 2014, 2016, 2016, 2016, 2018, 2018, 2020, 2020, 2020]",10.8,0.0010150009471130682,Low Gender Representation,0.2,2
35049,10,20,30,"[1998, 1998, 2000, 2000, 2000, 2002, 2002, 2004, 2004, 2004, 2006, 2006, 2008, 2008, 2008, 2010, 2010, 2012, 2012, 2012, 2014, 2014, 2016, 2016, 2016, 2018, 2018, 2020, 2020, 2020]",3.3333333333333335,0.06788915486182893,Low Gender Representation not Detected,0.3333333333333333,3
35061,9,22,31,"[1998, 1998, 2000, 2000, 2000, 2002, 2002, 2004, 2004, 2004, 2006, 2006, 2008, 2008, 2008, 2010, 2010, 2012, 2012, 2012, 2014, 2014, 2014, 2016, 2016, 2016, 2018, 2018, 2018, 2020, 2020, 2020]",5.451612903225806,0.019550269092885555,Low Gender Representation,0.2903225806451613,3
36001,42,151,193,"[1991, 2004, 2004, 2004, 2004, 2004, 2004, 2004, 2004, 2004, 2004, 2004, 2004, 2004, 2004, 2004, 2004, 2004, 2004, 2004, 2004, 2004, 2004, 2004, 2004, 2004, 2004, 2004, 2004, 2004, 2004, 2004, 2004, 2004, 2004, 2004, 2004, 2004, 2004, 2004, 2007, 2007, 2007, 2007, 2007, 2007, 2007, 2007, 2007, 2007, 2007, 2007, 2007, 2007, 2007, 2007, 2007, 2007, 2007, 2007, 2007, 2007, 2007, 2007, 2007, 2007, 2007, 2007, 2007, 2007, 2007, 2007, 2007, 2007, 2007, 2007, 2007, 2007, 2011, 2011, 2011, 2011, 2011, 2011, 2011, 2011, 2011, 2011, 2011, 2011, 2011, 2011, 2011, 2011, 2011, 2011, 2011, 2011, 2011, 2011, 2011, 2011, 2011, 2011, 2011, 2011, 2011, 2011, 2011, 2011, 2011, 2011, 2011, 2011, 2011, 2011, 2015, 2015, 2015, 2015, 2015, 2015, 2015, 2015, 2015, 2015, 2015, 2015, 2015, 2015, 2015, 2015, 2015, 2015, 2015, 2015, 2015, 2015, 2015, 2015, 2015, 2015, 2015, 2015, 2015, 2015, 2015, 2015, 2015, 2015, 2015, 2015, 2015, 2015, 2019, 2019, 2019, 2019, 2019, 2019, 2019, 2019, 2019, 2019, 2019, 2019, 2019, 2019, 2019, 2019, 2019, 2019, 2019, 2019, 2019, 2019, 2019, 2019, 2019, 2019, 2019, 2019, 2019, 2019, 2019, 2019, 2019, 2019, 2019, 2019, 2019, 2019, 2019, 2021]",61.55958549222798,4.295454116708708e-15,Low Gender Representation,0.21761658031088082,2
36007,18,137,155,"[2000, 2000, 2000, 2000, 2000, 2000, 2000, 2000, 2000, 2000, 2000, 2000, 2000, 2000, 2000, 2000, 2000, 2000, 2000, 2002, 2002, 2002, 2002, 2002, 2002, 2002, 2002, 2002, 2002, 2002, 2002, 2002, 2002, 2002, 2002, 2002, 2002, 2002, 2004, 2004, 2004, 2004, 2004, 2004, 2004, 2004, 2004, 2004, 2004, 2004, 2004, 2004, 2004, 2004, 2004, 2004, 2004, 2006, 2006, 2006, 2006, 2006, 2006, 2006, 2006, 2006, 2006, 2006, 2006, 2006, 2006, 2006, 2006, 2006, 2006, 2006, 2008, 2008, 2008, 2008, 2008, 2008, 2008, 2008, 2008, 2008, 2008, 2008, 2008, 2008, 2008, 2008, 2008, 2008, 2008, 2010, 2010, 2010, 2010, 2010, 2010, 2010, 2010, 2010, 2010, 2010, 2010, 2010, 2010, 2010, 2010, 2010, 2010, 2012, 2012, 2012, 2012, 2012, 2012, 2012, 2012, 2012, 2012, 2012, 2012, 2012, 2012, 2012, 2014, 2014, 2014, 2014, 2014, 2014, 2014, 2014, 2014, 2014, 2014, 2014, 2014, 2014, 2014, 2020, 2020, 2020, 2020, 2020, 2020, 2020, 2020, 2020, 2020, 2020, 2020, 2020, 2020]",91.36129032258064,1.1969521390497975e-21,Low Gender Representation,0.11612903225806452,1
36013,53,269,322,"[1989, 1989, 1989, 1989, 1989, 1989, 1989, 1989, 1989, 1989, 1989, 1989, 1989, 1989, 1989, 1989, 1989, 1989, 1989, 1989, 1989, 1989, 1989, 1989, 1989, 1991, 1991, 1991, 1991, 1991, 1991, 1991, 1991, 1991, 1991, 1991, 1991, 1991, 1991, 1991, 1991, 1991, 1991, 1991, 1991, 1991, 1991, 1991, 1991, 1991, 1993, 1993, 1993, 1993, 1993, 1993, 1993, 1993, 1993, 1993, 1993, 1993, 1993, 1993, 1993, 1993, 1993, 1993, 1993, 1993, 1993, 1993, 1993, 1993, 1993, 1995, 1995, 1995, 1995, 1995, 1995, 1995, 1995, 1995, 1995, 1995, 1995, 1995, 1995, 1995, 1995, 1995, 1995, 1995, 1995, 1995, 1995, 1995, 1995, 1995, 1997, 1997, 1997, 1997, 1997, 1997, 1997, 1997, 1997, 1997, 1997, 1997, 1997, 1997, 1997, 1997, 1997, 1997, 1997, 1997, 1997, 1997, 1997, 1997, 1997, 1999, 1999, 1999, 1999, 1999, 1999, 1999, 1999, 1999, 1999, 1999, 1999, 1999, 1999, 1999, 1999, 1999, 1999, 1999, 1999, 1999, 1999, 1999, 1999, 1999, 2001, 2001, 2001, 2001, 2001, 2001, 2001, 2001, 2001, 2001, 2001, 2001, 2001, 2001, 2001, 2001, 2001, 2001, 2001, 2001, 2001, 2001, 2001, 2001, 2001, 2003, 2003, 2003, 2003, 2003, 2003, 2003, 2003, 2003, 2003, 2003, 2003, 2003, 2003, 2003, 2003, 2003, 2003, 2003, 2003, 2003, 2003, 2003, 2003, 2003, 2005, 2005, 2005, 2005, 2005, 2005, 2005, 2005, 2005, 2005, 2005, 2005, 2005, 2005, 2005, 2005, 2005, 2005, 2005, 2005, 2005, 2005, 2005, 2005, 2005, 2007, 2007, 2007, 2007, 2007, 2007, 2007, 2007, 2007, 2007, 2007, 2007, 2007, 2007, 2007, 2007, 2007, 2007, 2007, 2007, 2007, 2007, 2007, 2007, 2007, 2009, 2009, 2009, 2009, 2009, 2009, 2009, 2009, 2009, 2009, 2009, 2009, 2009, 2009, 2009, 2009, 2009, 2009, 2009, 2009, 2009, 2009, 2009, 2009, 2009, 2011, 2011, 2011, 2011, 2011, 2011, 2011, 2011, 2011, 2011, 2011, 2011, 2011, 2011, 2011, 2011, 2011, 2011, 2011, 2011, 2011, 2011, 2011, 2011, 2011, 2013, 2013, 2013, 2013, 2013, 2013, 2013, 2013, 2013, 2013, 2013, 2013, 2013, 2013, 2013, 2013, 2013, 2013, 2013, 2014, 2020, 2020]",144.8944099378882,2.264882198727962e-33,Low Gender Representation,0.16459627329192547,2
36027,114,237,351,"[1997, 1997, 1997, 1997, 1997, 1997, 1997, 1997, 1997, 1997, 1997, 1997, 1997, 1997, 1997, 1997, 1997, 1997, 1997, 1997, 1997, 1997, 1997, 1997, 1997, 1997, 1997, 1997, 1997, 1997, 1997, 1997, 1997, 1999, 1999, 1999, 1999, 1999, 1999, 1999, 1999, 1999, 1999, 1999, 1999, 1999, 1999, 1999, 1999, 1999, 1999, 1999, 1999, 1999, 1999, 1999, 1999, 1999, 1999, 1999, 1999, 1999, 1999, 1999, 1999, 1999, 1999, 1999, 2001, 2001, 2001, 2001, 2001, 2001, 2001, 2001, 2001, 2001, 2001, 2001, 2001, 2001, 2001, 2001, 2001, 2001, 2001, 2001, 2001, 2001, 2001, 2001, 2001, 2001, 2001, 2001, 2001, 2001, 2001, 2001, 2001, 2001, 2001, 2003, 2003, 2003, 2003, 2003, 2003, 2003, 2003, 2003, 2003, 2003, 2003, 2003, 2003, 2003, 2003, 2003, 2003, 2003, 2003, 2003, 2003, 2003, 2003, 2003, 2005, 2005, 2005, 2005, 2005, 2005, 2005, 2005, 2005, 2005, 2005, 2005, 2005, 2005, 2005, 2005, 2005, 2005, 2005, 2005, 2005, 2005, 2005, 2005, 2005, 2007, 2007, 2007, 2007, 2007, 2007, 2007, 2007, 2007, 2007, 2007, 2007, 2007, 2007, 2007, 2007, 2007, 2007, 2007, 2007, 2007, 2007, 2007, 2007, 2007, 2009, 2009, 2009, 2009, 2009, 2009, 2009, 2009, 2009, 2009, 2009, 2009, 2009, 2009, 2009, 2009, 2009, 2009, 2009, 2009, 2009, 2009, 2009, 2009, 2009, 2011, 2011, 2011, 2011, 2011, 2011, 2011, 2011, 2011, 2011, 2011, 2011, 2011, 2011, 2011, 2011, 2011, 2011, 2011, 2011, 2011, 2011, 2011, 2011, 2011, 2012, 2013, 2013, 2013, 2013, 2013, 2013, 2013, 2013, 2013, 2013, 2013, 2013, 2013, 2013, 2013, 2013, 2013, 2013, 2013, 2013, 2013, 2013, 2013, 2013, 2013, 2015, 2015, 2015, 2015, 2015, 2015, 2015, 2015, 2015, 2015, 2015, 2015, 2015, 2015, 2015, 2015, 2015, 2015, 2015, 2015, 2015, 2015, 2015, 2015, 2015, 2017, 2017, 2017, 2017, 2017, 2017, 2017, 2017, 2017, 2017, 2017, 2017, 2017, 2017, 2017, 2017, 2017, 2017, 2017, 2017, 2017, 2017, 2017, 2017, 2017, 2019, 2019, 2019, 2019, 2019, 2019, 2019, 2019, 2019, 2019, 2019, 2019, 2019, 2019, 2019, 2019, 2019, 2019, 2019, 2019, 2019, 2019, 2019, 2019, 2019, 2020, 2021, 2021, 2021, 2021, 2021, 2021, 2021, 2021, 2021, 2021, 2021, 2021, 2021, 2021, 2021, 2021, 2021, 2021, 2021, 2021, 2021, 2021, 2021, 2021, 2021]",43.1025641025641,5.194413518339953e-11,Low Gender Representation,0.3247863247863248,3
36029,58,164,222,"[1989, 1989, 1989, 1989, 1989, 1989, 1989, 1989, 1989, 1989, 1989, 1989, 1989, 1989, 1989, 1989, 1989, 1991, 1991, 1991, 1991, 1991, 1991, 1991, 1991, 1991, 1991, 1991, 1991, 1991, 1991, 1991, 1991, 1991, 1993, 1993, 1993, 1993, 1993, 1993, 1993, 1993, 1993, 1993, 1993, 1993, 1993, 1993, 1993, 1993, 1993, 1995, 1995, 1995, 1995, 1995, 1995, 1995, 1995, 1995, 1995, 1995, 1995, 1995, 1995, 1995, 1995, 1995, 1997, 1997, 1997, 1997, 1997, 1997, 1997, 1997, 1997, 1997, 1997, 1997, 1997, 1997, 1997, 1997, 1997, 1999, 1999, 1999, 1999, 1999, 1999, 1999, 1999, 1999, 1999, 1999, 1999, 1999, 1999, 1999, 1999, 1999, 2001, 2001, 2001, 2001, 2001, 2001, 2001, 2001, 2003, 2003, 2003, 2003, 2003, 2003, 2003, 2003, 2003, 2003, 2003, 2004, 2005, 2005, 2005, 2005, 2005, 2005, 2005, 2005, 2005, 2005, 2005, 2007, 2007, 2007, 2007, 2007, 2007, 2007, 2007, 2007, 2007, 2007, 2009, 2009, 2009, 2009, 2009, 2009, 2009, 2009, 2009, 2009, 2009, 2011, 2011, 2011, 2011, 2011, 2011, 2011, 2011, 2011, 2011, 2011, 2013, 2013, 2013, 2013, 2013, 2013, 2013, 2013, 2013, 2013, 2013, 2015, 2015, 2015, 2015, 2015, 2015, 2015, 2015, 2015, 2015, 2015, 2017, 2017, 2017, 2017, 2017, 2017, 2017, 2017, 2017, 2017, 2017, 2018, 2019, 2019, 2019, 2019, 2019, 2019, 2019, 2019, 2019, 2019, 2019, 2021, 2021, 2021, 2021, 2021, 2021, 2021, 2021, 2021, 2021, 2021]",50.612612612612615,1.1251961453278408e-12,Low Gender Representation,0.26126126126126126,3
36045,3,27,30,"[2013, 2013, 2013, 2013, 2013, 2013, 2013, 2013, 2013, 2013, 2013, 2013, 2013, 2013, 2013, 2015, 2015, 2015, 2015, 2015, 2015, 2015, 2015, 2015, 2015, 2015, 2015, 2015, 2015, 2015, 2020]",19.2,1.1771339097615006e-05,Low Gender Representation,0.1,1
36055,67,287,354,"[1989, 1989, 1989, 1989, 1989, 1989, 1989, 1989, 1989, 1989, 1989, 1989, 1989, 1989, 1989, 1991, 1991, 1991, 1991, 1991, 1991, 1991, 1991, 1991, 1991, 1991, 1991, 1991, 1991, 1991, 1991, 1991, 1991, 1991, 1991, 1991, 1991, 1991, 1991, 1991, 1991, 1991, 1991, 1991, 1992, 1992, 1992, 1992, 1992, 1992, 1992, 1992, 1992, 1992, 1992, 1992, 1992, 1992, 1992, 1992, 1992, 1992, 1992, 1992, 1992, 1992, 1992, 1992, 1992, 1992, 1992, 1992, 1992, 1994, 1995, 1995, 1995, 1995, 1995, 1995, 1995, 1995, 1995, 1995, 1995, 1995, 1995, 1995, 1995, 1995, 1995, 1995, 1995, 1995, 1995, 1995, 1995, 1995, 1995, 1995, 1995, 1995, 1995, 1997, 1997, 1997, 1997, 1997, 1997, 1997, 1997, 1997, 1997, 1997, 1997, 1997, 1997, 1998, 1999, 1999, 1999, 1999, 1999, 1999, 1999, 1999, 1999, 1999, 1999, 1999, 1999, 1999, 1999, 2000, 2001, 2001, 2001, 2001, 2001, 2001, 2001, 2001, 2001, 2001, 2001, 2001, 2001, 2001, 2001, 2001, 2001, 2001, 2001, 2001, 2001, 2001, 2001, 2001, 2001, 2001, 2001, 2001, 2001, 2003, 2004, 2004, 2004, 2004, 2004, 2004, 2004, 2005, 2005, 2005, 2005, 2005, 2005, 2005, 2005, 2005, 2005, 2005, 2005, 2005, 2005, 2005, 2005, 2005, 2005, 2005, 2005, 2005, 2005, 2005, 2005, 2005, 2005, 2005, 2005, 2005, 2007, 2007, 2007, 2007, 2007, 2007, 2007, 2007, 2007, 2007, 2007, 2007, 2007, 2009, 2009, 2009, 2009, 2009, 2009, 2009, 2009, 2009, 2009, 2009, 2009, 2009, 2009, 2009, 2009, 2010, 2011, 2011, 2011, 2011, 2011, 2011, 2011, 2011, 2011, 2011, 2011, 2011, 2011, 2011, 2011, 2011, 2011, 2011, 2011, 2011, 2011, 2011, 2011, 2011, 2011, 2011, 2011, 2011, 2011, 2012, 2013, 2013, 2014, 2014, 2014, 2014, 2015, 2015, 2015, 2015, 2015, 2015, 2015, 2015, 2015, 2015, 2015, 2015, 2015, 2015, 2015, 2015, 2015, 2015, 2015, 2015, 2015, 2015, 2015, 2015, 2015, 2015, 2015, 2015, 2015, 2017, 2018, 2019, 2019, 2019, 2019, 2019, 2019, 2019, 2019, 2019, 2019, 2019, 2019, 2019, 2019, 2019, 2019, 2019, 2019, 2019, 2019, 2019, 2019, 2019, 2019, 2019, 2019, 2019, 2019, 2019, 2020, 2021, 2021, 2021, 2021, 2021, 2021, 2021, 2021, 2021, 2021, 2021, 2021, 2021, 2021, 2021, 2021, 2021, 2021, 2021, 2021, 2021, 2021, 2021, 2021, 2021, 2021, 2021, 2021, 2021]",136.72316384180792,1.3862477260455398e-31,Low Gender Representation,0.18926553672316385,2
36059,82,191,273,"[1995, 1995, 1995, 1995, 1995, 1995, 1995, 1995, 1995, 1995, 1995, 1995, 1995, 1995, 1995, 1995, 1995, 1995, 1995, 1997, 1997, 1997, 1997, 1997, 1997, 1997, 1997, 1997, 1997, 1997, 1997, 1997, 1997, 1997, 1997, 1997, 1997, 1997, 1999, 1999, 1999, 1999, 1999, 1999, 1999, 1999, 1999, 1999, 1999, 1999, 1999, 1999, 1999, 1999, 1999, 1999, 1999, 2000, 2001, 2001, 2001, 2001, 2001, 2001, 2001, 2001, 2001, 2001, 2001, 2001, 2001, 2001, 2001, 2001, 2001, 2001, 2001, 2002, 2003, 2003, 2003, 2003, 2003, 2003, 2003, 2003, 2003, 2003, 2003, 2003, 2003, 2003, 2003, 2003, 2003, 2003, 2003, 2005, 2005, 2005, 2005, 2005, 2005, 2005, 2005, 2005, 2005, 2005, 2005, 2005, 2005, 2005, 2005, 2005, 2005, 2005, 2007, 2007, 2007, 2007, 2007, 2007, 2007, 2007, 2007, 2007, 2007, 2007, 2007, 2007, 2007, 2007, 2007, 2007, 2007, 2007, 2009, 2009, 2009, 2009, 2009, 2009, 2009, 2009, 2009, 2009, 2009, 2009, 2009, 2009, 2009, 2009, 2009, 2009, 2009, 2011, 2011, 2011, 2011, 2011, 2011, 2011, 2011, 2011, 2011, 2011, 2011, 2011, 2011, 2011, 2011, 2011, 2011, 2011, 2012, 2013, 2013, 2013, 2013, 2013, 2013, 2013, 2013, 2013, 2013, 2013, 2013, 2013, 2013, 2013, 2013, 2013, 2013, 2013, 2014, 2015, 2015, 2015, 2015, 2015, 2015, 2015, 2015, 2015, 2015, 2015, 2015, 2015, 2015, 2015, 2015, 2015, 2015, 2015, 2015, 2015, 2016, 2017, 2017, 2017, 2017, 2017, 2017, 2017, 2017, 2017, 2017, 2017, 2017, 2017, 2017, 2017, 2017, 2017, 2017, 2017, 2019, 2019, 2019, 2019, 2019, 2019, 2019, 2019, 2019, 2019, 2019, 2019, 2019, 2019, 2019, 2019, 2019, 2019, 2019, 2021, 2021, 2021, 2021, 2021, 2021, 2021, 2021, 2021, 2021, 2021, 2021, 2021, 2021, 2021, 2021, 2021, 2021, 2021]",43.52014652014652,4.1961704403088064e-11,Low Gender Representation,0.30036630036630035,3
36063,9,70,79,"[2009, 2009, 2009, 2009, 2009, 2009, 2009, 2009, 2009, 2009, 2009, 2009, 2009, 2009, 2009, 2009, 2009, 2009, 2009, 2011, 2011, 2011, 2011, 2011, 2011, 2011, 2011, 2011, 2011, 2011, 2011, 2011, 2011, 2011, 2013, 2013, 2013, 2013, 2013, 2013, 2013, 2013, 2013, 2013, 2013, 2013, 2013, 2013, 2013, 2015, 2015, 2015, 2015, 2015, 2015, 2015, 2015, 2015, 2015, 2015, 2015, 2015, 2015, 2015, 2019, 2019, 2019, 2019, 2019, 2019, 2019, 2019, 2019, 2019, 2019, 2019, 2019, 2019, 2019]",47.10126582278481,6.7412136723422414e-12,Low Gender Representation,0.11392405063291139,1
36065,11,59,70,"[2013, 2013, 2013, 2013, 2013, 2013, 2013, 2013, 2013, 2013, 2013, 2013, 2013, 2013, 2013, 2013, 2013, 2013, 2013, 2013, 2013, 2013, 2013, 2015, 2015, 2015, 2015, 2015, 2015, 2015, 2015, 2015, 2015, 2015, 2015, 2015, 2015, 2015, 2015, 2015, 2015, 2015, 2015, 2015, 2015, 2015, 2019, 2019, 2019, 2019, 2019, 2019, 2019, 2019, 2019, 2019, 2019, 2019, 2019, 2019, 2019, 2019, 2019, 2019, 2019, 2019, 2019, 2019, 2019, 2020]",32.91428571428571,9.631291707023605e-09,Low Gender Representation,0.15714285714285714,2
36067,24,60,84,"[2005, 2005, 2011, 2013, 2013, 2013, 2013, 2013, 2013, 2013, 2013, 2013, 2013, 2013, 2013, 2013, 2013, 2013, 2013, 2015, 2015, 2015, 2015, 2015, 2015, 2015, 2015, 2015, 2015, 2015, 2015, 2015, 2015, 2015, 2015, 2017, 2017, 2017, 2017, 2017, 2017, 2017, 2017, 2017, 2017, 2017, 2017, 2017, 2017, 2017, 2017, 2019, 2019, 2019, 2019, 2019, 2019, 2019, 2019, 2019, 2019, 2019, 2019, 2019, 2019, 2019, 2019, 2019, 2021, 2021, 2021, 2021, 2021, 2021, 2021, 2021, 2021, 2021, 2021, 2021, 2021, 2021, 2021, 2021]",15.428571428571429,8.56829801091046e-05,Low Gender Representation,0.2857142857142857,3
36071,27,146,173,"[1989, 1989, 1989, 1989, 1989, 1989, 1989, 1989, 1989, 1989, 1989, 1989, 1989, 1989, 1989, 1989, 1989, 1989, 1989, 1989, 1989, 1993, 1993, 1993, 1993, 1993, 1993, 1993, 1993, 1993, 1993, 1993, 1993, 1993, 1993, 1993, 1993, 1993, 1993, 1993, 1993, 1993, 1997, 1997, 1997, 1997, 1997, 1997, 1997, 1997, 1997, 1997, 1997, 1997, 1997, 1997, 1997, 1997, 1997, 1997, 1997, 1997, 1997, 2005, 2005, 2005, 2005, 2005, 2005, 2005, 2005, 2005, 2005, 2005, 2005, 2005, 2005, 2005, 2005, 2005, 2005, 2005, 2005, 2005, 2007, 2009, 2009, 2009, 2009, 2009, 2009, 2009, 2009, 2009, 2009, 2009, 2009, 2009, 2009, 2009, 2009, 2009, 2009, 2009, 2009, 2009, 2011, 2012, 2013, 2013, 2013, 2013, 2013, 2013, 2013, 2013, 2013, 2013, 2013, 2013, 2013, 2013, 2013, 2013, 2013, 2013, 2013, 2013, 2013, 2015, 2016, 2017, 2017, 2017, 2017, 2017, 2017, 2017, 2017, 2017, 2017, 2017, 2017, 2017, 2017, 2017, 2017, 2017, 2017, 2017, 2017, 2017, 2021, 2021, 2021, 2021, 2021, 2021, 2021, 2021, 2021, 2021, 2021, 2021, 2021, 2021, 2021, 2021, 2021, 2021, 2021, 2021, 2021]",81.85549132947978,1.4640957280813026e-19,Low Gender Representation,0.15606936416184972,2
36075,14,61,75,"[2009, 2009, 2009, 2009, 2009, 2009, 2009, 2009, 2009, 2009, 2009, 2009, 2009, 2009, 2009, 2009, 2009, 2009, 2009, 2009, 2009, 2009, 2009, 2009, 2009, 2013, 2013, 2013, 2013, 2013, 2013, 2013, 2013, 2013, 2013, 2013, 2013, 2013, 2013, 2013, 2013, 2013, 2013, 2013, 2013, 2013, 2013, 2013, 2013, 2013, 2015, 2015, 2015, 2015, 2015, 2015, 2015, 2015, 2015, 2015, 2015, 2015, 2015, 2015, 2015, 2015, 2015, 2015, 2015, 2015, 2015, 2015, 2015, 2015, 2015]",29.453333333333333,5.7279437436661846e-08,Low Gender Representation,0.18666666666666668,2
36079,21,36,57,"[2001, 2001, 2001, 2002, 2002, 2002, 2003, 2003, 2004, 2004, 2004, 2005, 2005, 2005, 2006, 2006, 2007, 2007, 2007, 2008, 2008, 2008, 2009, 2009, 2010, 2010, 2010, 2011, 2011, 2011, 2012, 2012, 2012, 2013, 2013, 2013, 2014, 2014, 2014, 2015, 2015, 2016, 2016, 2016, 2017, 2017, 2017, 2018, 2018, 2019, 2019, 2019, 2020, 2020, 2020, 2021, 2021]",3.9473684210526314,0.04694472697848181,Low Gender Representation,0.3684210526315789,4
36083,14,67,81,"[2001, 2001, 2001, 2001, 2001, 2001, 2001, 2001, 2001, 2001, 2001, 2001, 2001, 2001, 2001, 2001, 2001, 2001, 2001, 2005, 2005, 2005, 2005, 2005, 2005, 2005, 2005, 2005, 2005, 2005, 2005, 2005, 2005, 2005, 2005, 2005, 2005, 2009, 2009, 2009, 2009, 2009, 2009, 2009, 2009, 2009, 2009, 2009, 2009, 2009, 2009, 2009, 2009, 2009, 2009, 2009, 2013, 2013, 2013, 2013, 2013, 2013, 2013, 2013, 2013, 2013, 2013, 2013, 2013, 2013, 2013, 2013, 2013, 2013, 2013, 2017, 2017, 2017, 2017, 2017, 2017, 2017, 2017, 2017, 2017, 2017, 2017, 2017, 2017, 2017, 2017, 2017]",34.67901234567901,3.888007257288035e-09,Low Gender Representation,0.1728395061728395,2
36087,23,132,155,"[1989, 1989, 1989, 1989, 1989, 1989, 1989, 1989, 1989, 1989, 1989, 1989, 1989, 1991, 1991, 1991, 1991, 1991, 1991, 1991, 1991, 1991, 1993, 1993, 1993, 1993, 1993, 1993, 1993, 1993, 1993, 1993, 1993, 1993, 1995, 1995, 1995, 1995, 1995, 1995, 1995, 1995, 1995, 1997, 1997, 1997, 1997, 1997, 1997, 1997, 1997, 1997, 1997, 1997, 1997, 1999, 1999, 1999, 1999, 1999, 1999, 1999, 1999, 2001, 2002, 2002, 2003, 2003, 2003, 2003, 2003, 2003, 2003, 2003, 2003, 2003, 2003, 2003, 2003, 2003, 2003, 2003, 2003, 2005, 2005, 2006, 2006, 2007, 2007, 2007, 2007, 2007, 2007, 2007, 2007, 2007, 2007, 2007, 2007, 2007, 2007, 2007, 2007, 2007, 2009, 2010, 2011, 2011, 2011, 2011, 2011, 2011, 2011, 2011, 2011, 2011, 2011, 2011, 2011, 2011, 2011, 2011, 2011, 2014, 2015, 2015, 2015, 2015, 2015, 2015, 2015, 2015, 2015, 2015, 2015, 2015, 2015, 2015, 2015, 2015, 2015, 2018, 2019, 2019, 2019, 2019, 2019, 2019, 2019, 2019, 2019, 2019, 2019, 2019, 2019, 2019, 2019, 2019, 2019]",76.65161290322581,2.039394408821542e-18,Low Gender Representation,0.14838709677419354,1
36089,6,54,60,"[2002, 2002, 2002, 2002, 2002, 2002, 2002, 2002, 2002, 2002, 2002, 2002, 2002, 2002, 2002, 2004, 2004, 2004, 2004, 2004, 2004, 2004, 2004, 2004, 2004, 2004, 2004, 2004, 2004, 2004, 2010, 2010, 2010, 2010, 2010, 2010, 2010, 2010, 2010, 2010, 2010, 2010, 2010, 2010, 2010, 2014, 2014, 2014, 2014, 2014, 2014, 2014, 2014, 2014, 2014, 2014, 2014, 2014, 2014, 2014]",38.4,5.763239628510765e-10,Low Gender Representation,0.1,1
36091,14,63,77,"[2007, 2007, 2007, 2007, 2007, 2007, 2007, 2007, 2007, 2007, 2007, 2007, 2007, 2007, 2007, 2007, 2007, 2007, 2007, 2007, 2011, 2011, 2011, 2011, 2011, 2011, 2011, 2011, 2011, 2011, 2011, 2011, 2011, 2011, 2011, 2011, 2011, 2011, 2011, 2011, 2015, 2015, 2015, 2015, 2015, 2015, 2015, 2015, 2015, 2015, 2015, 2015, 2015, 2015, 2015, 2015, 2015, 2015, 2015, 2017, 2017, 2017, 2017, 2017, 2017, 2017, 2017, 2017, 2017, 2017, 2017, 2017, 2017, 2017, 2017, 2017, 2017]",31.181818181818183,2.3495643475808254e-08,Low Gender Representation,0.18181818181818182,2
36093,3,4,7,"[2013, 2013, 2013, 2013, 2013, 2013, 2013]",0.14285714285714285,0.7054569861112734,Low Gender Representation not Detected,0.42857142857142855,4
36103,60,189,249,"[1989, 1989, 1989, 1989, 1989, 1989, 1989, 1989, 1993, 1993, 1993, 1993, 1993, 1993, 1995, 1995, 1995, 1995, 1995, 1995, 1995, 1997, 1997, 1997, 1997, 1997, 1997, 1997, 1997, 1997, 1999, 1999, 1999, 1999, 1999, 1999, 1999, 1999, 1999, 1999, 1999, 1999, 1999, 1999, 1999, 1999, 1999, 1999, 2001, 2001, 2001, 2001, 2001, 2001, 2001, 2001, 2001, 2001, 2003, 2003, 2003, 2003, 2003, 2003, 2003, 2003, 2003, 2003, 2003, 2003, 2003, 2003, 2003, 2003, 2003, 2003, 2004, 2004, 2005, 2005, 2005, 2005, 2005, 2005, 2005, 2005, 2005, 2005, 2005, 2005, 2005, 2005, 2005, 2005, 2005, 2005, 2007, 2007, 2007, 2007, 2007, 2007, 2007, 2007, 2007, 2007, 2007, 2007, 2007, 2007, 2007, 2007, 2007, 2007, 2008, 2008, 2008, 2009, 2009, 2009, 2009, 2009, 2009, 2009, 2009, 2009, 2009, 2009, 2009, 2009, 2009, 2009, 2009, 2009, 2009, 2011, 2011, 2011, 2011, 2011, 2011, 2011, 2011, 2011, 2011, 2011, 2011, 2011, 2011, 2011, 2011, 2011, 2011, 2011, 2013, 2013, 2013, 2013, 2013, 2013, 2013, 2013, 2013, 2013, 2013, 2013, 2013, 2013, 2013, 2013, 2013, 2013, 2013, 2015, 2015, 2015, 2015, 2015, 2015, 2015, 2015, 2015, 2015, 2015, 2015, 2015, 2015, 2015, 2015, 2015, 2015, 2015, 2017, 2017, 2017, 2017, 2017, 2017, 2017, 2017, 2017, 2017, 2017, 2017, 2017, 2017, 2017, 2017, 2017, 2017, 2019, 2019, 2019, 2019, 2019, 2019, 2019, 2019, 2019, 2019, 2019, 2019, 2019, 2019, 2019, 2019, 2019, 2019, 2019, 2020, 2020, 2021, 2021, 2021, 2021, 2021, 2021, 2021, 2021, 2021, 2021, 2021, 2021, 2021, 2021, 2021, 2021, 2021, 2021]",66.83132530120481,2.95760789220467e-16,Low Gender Representation,0.24096385542168675,2
36109,25,32,57,"[2009, 2009, 2009, 2009, 2009, 2009, 2009, 2009, 2009, 2009, 2009, 2009, 2009, 2009, 2013, 2013, 2013, 2013, 2013, 2013, 2013, 2013, 2013, 2013, 2013, 2013, 2013, 2013, 2017, 2017, 2017, 2017, 2017, 2017, 2017, 2017, 2017, 2017, 2017, 2017, 2017, 2017, 2021, 2021, 2021, 2021, 2021, 2021, 2021, 2021, 2021, 2021, 2021, 2021, 2021, 2021, 2021]",0.8596491228070176,0.35383690068472917,Low Gender Representation not Detected,0.43859649122807015,4
36111,19,50,69,"[2005, 2005, 2011, 2011, 2011, 2011, 2011, 2011, 2011, 2011, 2011, 2011, 2011, 2011, 2011, 2011, 2011, 2011, 2011, 2011, 2011, 2011, 2011, 2011, 2011, 2013, 2013, 2013, 2013, 2013, 2013, 2013, 2013, 2013, 2013, 2013, 2013, 2013, 2013, 2013, 2013, 2013, 2013, 2013, 2013, 2013, 2013, 2013, 2019, 2019, 2019, 2019, 2019, 2019, 2019, 2019, 2019, 2019, 2019, 2019, 2019, 2019, 2019, 2019, 2019, 2019, 2019, 2019, 2019, 2019, 2019]",13.927536231884059,0.00018999458574693037,Low Gender Representation,0.2753623188405797,3
36119,101,195,296,"[1989, 1989, 1989, 1989, 1989, 1989, 1989, 1989, 1989, 1989, 1989, 1989, 1989, 1989, 1989, 1989, 1989, 1991, 1991, 1991, 1991, 1991, 1991, 1991, 1991, 1991, 1991, 1991, 1991, 1991, 1991, 1991, 1991, 1993, 1993, 1993, 1993, 1993, 1993, 1993, 1993, 1993, 1993, 1993, 1993, 1993, 1993, 1993, 1993, 1993, 1993, 1995, 1995, 1995, 1995, 1995, 1995, 1995, 1995, 1995, 1995, 1995, 1995, 1995, 1995, 1995, 1995, 1997, 1997, 1997, 1997, 1997, 1997, 1997, 1997, 1997, 1997, 1997, 1997, 1997, 1997, 1997, 1997, 1997, 1999, 1999, 1999, 1999, 1999, 1999, 1999, 1999, 1999, 1999, 1999, 1999, 1999, 1999, 1999, 1999, 1999, 2001, 2001, 2001, 2001, 2001, 2001, 2001, 2001, 2001, 2001, 2001, 2001, 2001, 2001, 2001, 2001, 2001, 2002, 2003, 2003, 2003, 2003, 2003, 2003, 2003, 2003, 2003, 2003, 2003, 2003, 2003, 2003, 2003, 2003, 2003, 2005, 2005, 2005, 2005, 2005, 2005, 2005, 2005, 2005, 2005, 2005, 2005, 2005, 2005, 2005, 2005, 2005, 2005, 2005, 2007, 2007, 2007, 2007, 2007, 2007, 2007, 2007, 2007, 2007, 2007, 2007, 2007, 2007, 2007, 2007, 2007, 2007, 2009, 2009, 2009, 2009, 2009, 2009, 2009, 2009, 2009, 2009, 2009, 2009, 2009, 2009, 2009, 2009, 2009, 2010, 2011, 2011, 2011, 2011, 2011, 2011, 2011, 2011, 2011, 2011, 2011, 2011, 2011, 2011, 2011, 2011, 2011, 2011, 2013, 2013, 2013, 2013, 2013, 2013, 2013, 2013, 2013, 2013, 2013, 2013, 2013, 2013, 2013, 2013, 2013, 2015, 2015, 2015, 2015, 2015, 2015, 2015, 2015, 2015, 2015, 2015, 2015, 2015, 2015, 2015, 2015, 2015, 2016, 2017, 2017, 2017, 2017, 2017, 2017, 2017, 2017, 2017, 2017, 2017, 2017, 2017, 2017, 2017, 2017, 2017, 2018, 2019, 2019, 2019, 2019, 2019, 2019, 2019, 2019, 2019, 2019, 2019, 2019, 2019, 2019, 2019, 2019, 2019, 2020, 2021, 2021, 2021, 2021, 2021, 2021, 2021, 2021, 2021, 2021, 2021, 2021, 2021, 2021, 2021, 2021, 2021]",29.85135135135135,4.664716359815492e-08,Low Gender Representation,0.34121621621621623,3
37001,7,17,24,"[1990, 1990, 1992, 1992, 1992, 1994, 1994, 1996, 1996, 1996, 1998, 1998, 2000, 2000, 2000, 2002, 2002, 2004, 2004, 2004, 2006, 2006, 2008, 2008, 2010, 2010, 2012, 2012, 2014, 2014, 2016, 2020, 2020, 2020]",4.166666666666667,0.041226833337163815,Low Gender Representation,0.2916666666666667,3
37019,2,15,17,"[2008, 2008, 2008, 2010, 2012, 2012, 2012, 2014, 2014, 2016, 2016, 2018, 2018, 2018, 2020, 2020, 2020]",9.941176470588236,0.0016162222150599877,Low Gender Representation,0.11764705882352941,1
37021,13,31,44,"[1992, 1992, 1992, 1992, 1992, 1996, 1996, 1996, 1996, 1996, 2000, 2000, 2000, 2000, 2000, 2004, 2004, 2004, 2004, 2004, 2008, 2008, 2008, 2008, 2012, 2012, 2012, 2012, 2012, 2012, 2012, 2014, 2014, 2014, 2016, 2016, 2016, 2016, 2018, 2018, 2018, 2020, 2020, 2020, 2020]",7.363636363636363,0.006655605482949389,Low Gender Representation,0.29545454545454547,3
37025,12,27,39,"[1990, 1990, 1990, 1992, 1992, 1994, 1994, 1994, 1996, 1996, 1998, 1998, 1998, 2000, 2000, 2002, 2002, 2002, 2004, 2004, 2006, 2006, 2006, 2008, 2008, 2008, 2010, 2010, 2010, 2012, 2012, 2012, 2014, 2014, 2014, 2018, 2018, 2018, 2020, 2020]",5.769230769230769,0.016309171877754998,Low Gender Representation,0.3076923076923077,3
37035,19,16,35,"[1990, 1990, 1990, 1992, 1992, 1992, 1994, 1994, 1994, 1996, 1996, 1998, 1998, 1998, 2000, 2000, 2002, 2002, 2002, 2004, 2004, 2006, 2006, 2006, 2008, 2008, 2008, 2010, 2010, 2010, 2012, 2012, 2012, 2014, 2014, 2014, 2020, 2020]",0.2571428571428571,0.6120898800892569,Low Gender Representation not Detected,0.5428571428571428,5
37049,0,20,20,"[2010, 2010, 2010, 2010, 2010, 2010, 2010, 2014, 2014, 2014, 2014, 2014, 2014, 2014, 2018, 2018, 2018, 2018, 2018, 2018, 2018]",20.0,7.744216431044088e-06,Low Gender Representation,0.0,0
37051,8,28,36,"[2000, 2000, 2000, 2000, 2002, 2002, 2002, 2002, 2004, 2004, 2004, 2006, 2006, 2006, 2006, 2008, 2008, 2008, 2010, 2010, 2010, 2012, 2012, 2014, 2014, 2014, 2014, 2016, 2016, 2016, 2018, 2018, 2018, 2018, 2020, 2020]",11.11111111111111,0.0008581206663936758,Low Gender Representation,0.2222222222222222,2
37057,1,16,17,"[2008, 2008, 2008, 2010, 2010, 2010, 2010, 2012, 2012, 2012, 2014, 2014, 2014, 2014, 2020, 2020, 2020]",13.235294117647058,0.0002747267638079425,Low Gender Representation,0.058823529411764705,1
37063,6,2,8,"[2008, 2008, 2008, 2008, 2008, 2012, 2016, 2020]",2.0,0.15729920705028105,Low Gender Representation not Detected,0.75,8
37067,12,29,41,"[1996, 1996, 1996, 1998, 1998, 1998, 1998, 2000, 2000, 2000, 2002, 2002, 2002, 2002, 2004, 2004, 2004, 2006, 2006, 2006, 2006, 2008, 2008, 2008, 2010, 2010, 2010, 2010, 2012, 2014, 2014, 2014, 2016, 2016, 2016, 2018, 2018, 2018, 2020, 2020, 2020]",7.048780487804878,0.007931923532795277,Low Gender Representation,0.2926829268292683,3
37071,9,61,70,"[1990, 1990, 1990, 1990, 1990, 1990, 1992, 1992, 1992, 1992, 1992, 1992, 1992, 1992, 1994, 1994, 1994, 1994, 1994, 1994, 1996, 1996, 1996, 1996, 1996, 1996, 1996, 1996, 1998, 1998, 1998, 1998, 1998, 1998, 2000, 2000, 2000, 2000, 2000, 2000, 2000, 2000, 2002, 2002, 2002, 2002, 2004, 2004, 2004, 2004, 2006, 2006, 2006, 2008, 2008, 2008, 2008, 2010, 2010, 2010, 2012, 2012, 2012, 2012, 2014, 2014, 2014, 2016, 2016, 2016, 2016, 2018, 2018, 2018, 2020]",38.628571428571426,5.126298521612369e-10,Low Gender Representation,0.12857142857142856,1
37081,11,32,43,"[1990, 1990, 1990, 1992, 1992, 1992, 1992, 1992, 1992, 1992, 1992, 2002, 2002, 2002, 2002, 2002, 2004, 2004, 2004, 2004, 2004, 2004, 2006, 2006, 2006, 2006, 2006, 2008, 2008, 2008, 2008, 2008, 2008, 2010, 2010, 2010, 2010, 2010, 2012, 2012, 2012, 2012, 2014, 2014, 2014, 2014, 2014, 2016, 2016, 2016, 2016, 2018, 2018, 2018, 2018, 2018, 2018, 2020, 2020, 2020, 2020]",10.255813953488373,0.0013625450227790184,Low Gender Representation,0.2558139534883721,3
37085,7,31,38,"[1992, 1992, 1992, 1994, 1994, 1996, 1996, 1996, 1998, 1998, 2000, 2000, 2000, 2002, 2002, 2004, 2004, 2004, 2006, 2006, 2008, 2008, 2008, 2010, 2010, 2012, 2012, 2012, 2014, 2014, 2016, 2016, 2016, 2018, 2018, 2020, 2020, 2020, 2020]",15.157894736842104,9.888398174613938e-05,Low Gender Representation,0.18421052631578946,2
37089,1,16,17,"[2008, 2008, 2010, 2010, 2010, 2012, 2012, 2014, 2014, 2014, 2016, 2016, 2018, 2018, 2018, 2020, 2020]",13.235294117647058,0.0002747267638079425,Low Gender Representation,0.058823529411764705,1
37097,4,15,19,"[2004, 2004, 2004, 2006, 2006, 2006, 2008, 2008, 2008, 2010, 2010, 2010, 2012, 2012, 2012, 2014, 2014, 2014, 2020, 2020, 2020]",6.368421052631579,0.011616891434158384,Low Gender Representation,0.21052631578947367,2
37101,2,23,25,"[2008, 2008, 2008, 2008, 2010, 2010, 2010, 2012, 2012, 2012, 2012, 2014, 2014, 2014, 2016, 2016, 2016, 2016, 2018, 2018, 2018, 2018, 2020, 2020, 2020, 2020]",17.64,2.6691498031812692e-05,Low Gender Representation,0.08,1
37119,32,59,91,"[1996, 1996, 1996, 1996, 1996, 1996, 1996, 1998, 1998, 1998, 1998, 1998, 1998, 1998, 2000, 2000, 2000, 2000, 2000, 2000, 2000, 2002, 2002, 2002, 2002, 2002, 2002, 2002, 2004, 2004, 2004, 2004, 2004, 2004, 2004, 2006, 2006, 2006, 2006, 2006, 2006, 2006, 2008, 2008, 2008, 2008, 2008, 2008, 2008, 2010, 2010, 2010, 2010, 2010, 2010, 2010, 2012, 2012, 2012, 2012, 2012, 2012, 2012, 2014, 2014, 2014, 2014, 2014, 2014, 2014, 2016, 2016, 2016, 2016, 2016, 2016, 2016, 2018, 2018, 2018, 2018, 2018, 2018, 2018, 2020, 2020, 2020, 2020, 2020, 2020, 2020]",8.010989010989011,0.004649433819808538,Low Gender Representation,0.3516483516483517,4
37129,5,18,23,"[2000, 2000, 2000, 2002, 2002, 2004, 2004, 2004, 2006, 2006, 2008, 2008, 2008, 2010, 2010, 2012, 2012, 2012, 2014, 2014, 2020, 2020, 2020]",7.3478260869565215,0.006714389785549478,Low Gender Representation,0.21739130434782608,2
37133,1,8,9,"[2012, 2012, 2012, 2012, 2012, 2020, 2020, 2020, 2020, 2020]",5.444444444444445,0.019630657257290702,Low Gender Representation,0.1111111111111111,1
37135,16,15,31,"[2000, 2000, 2002, 2002, 2002, 2004, 2004, 2006, 2006, 2006, 2008, 2008, 2008, 2010, 2010, 2010, 2012, 2012, 2012, 2014, 2014, 2014, 2016, 2016, 2016, 2018, 2018, 2018, 2020, 2020, 2020]",0.03225806451612903,0.8574624419592412,Low Gender Representation not Detected,0.5161290322580645,5
37147,11,60,71,"[1990, 1990, 1990, 1990, 1990, 1990, 1992, 1992, 1992, 1994, 1994, 1994, 1994, 1994, 1994, 1996, 1996, 1996, 1998, 1998, 1998, 1998, 1998, 1998, 2000, 2000, 2000, 2002, 2002, 2002, 2002, 2002, 2002, 2004, 2004, 2004, 2006, 2006, 2006, 2006, 2006, 2006, 2008, 2008, 2008, 2010, 2010, 2010, 2010, 2010, 2010, 2012, 2012, 2012, 2014, 2014, 2014, 2014, 2014, 2014, 2016, 2016, 2016, 2018, 2018, 2018, 2018, 2018, 2018, 2020, 2020, 2020, 2020]",33.816901408450704,6.055052795540867e-09,Low Gender Representation,0.15492957746478872,2
37151,1,16,17,"[2008, 2008, 2010, 2010, 2010, 2012, 2012, 2014, 2014, 2014, 2016, 2016, 2018, 2018, 2018, 2020, 2020]",13.235294117647058,0.0002747267638079425,Low Gender Representation,0.058823529411764705,1
37155,4,25,29,"[2008, 2008, 2008, 2008, 2008, 2010, 2010, 2010, 2010, 2012, 2012, 2012, 2012, 2014, 2014, 2014, 2014, 2016, 2016, 2016, 2016, 2018, 2018, 2018, 2018, 2019, 2020, 2020, 2020, 2020]",15.206896551724139,9.635090009780229e-05,Low Gender Representation,0.13793103448275862,1
37159,3,19,22,"[2000, 2000, 2002, 2002, 2002, 2004, 2004, 2006, 2006, 2006, 2008, 2008, 2010, 2010, 2010, 2012, 2012, 2014, 2014, 2014, 2020, 2020]",11.636363636363637,0.0006467491225764771,Low Gender Representation,0.13636363636363635,1
37179,2,11,13,"[1994, 2008, 2008, 2010, 2010, 2010, 2012, 2012, 2014, 2014, 2014, 2020, 2020]",6.230769230769231,0.01255491859696653,Low Gender Representation,0.15384615384615385,2
37183,17,32,49,"[1992, 1992, 1996, 1996, 1996, 2000, 2000, 2000, 2002, 2002, 2002, 2002, 2004, 2004, 2004, 2006, 2006, 2006, 2006, 2008, 2008, 2008, 2010, 2010, 2010, 2010, 2012, 2012, 2012, 2014, 2014, 2014, 2014, 2016, 2016, 2016, 2018, 2018, 2018, 2018, 2018, 2018, 2018, 2020, 2020, 2020, 2020, 2020, 2020, 2020]",4.591836734693878,0.032124571207656626,Low Gender Representation,0.3469387755102041,3
37191,2,52,54,"[1992, 1992, 1992, 1992, 1992, 1992, 1992, 1996, 1996, 1996, 1996, 1996, 1996, 1996, 2000, 2000, 2000, 2000, 2000, 2000, 2000, 2004, 2004, 2004, 2004, 2004, 2004, 2004, 2008, 2008, 2008, 2008, 2008, 2008, 2008, 2012, 2012, 2012, 2012, 2012, 2012, 2012, 2014, 2014, 2016, 2016, 2016, 2016, 2016, 2016, 2016, 2020, 2020, 2020, 2020, 2020, 2020, 2020]",46.2962962962963,1.0165593635824554e-11,Low Gender Representation,0.037037037037037035,0
38017,2,6,8,"[2016, 2016, 2016, 2018, 2018, 2020, 2020, 2020]",2.0,0.15729920705028105,Low Gender Representation not Detected,0.25,2
39003,1,14,15,"[2000, 2000, 2002, 2004, 2004, 2006, 2008, 2008, 2010, 2012, 2012, 2014, 2016, 2016, 2018, 2020, 2020]",11.266666666666667,0.0007891129890156312,Low Gender Representation,0.06666666666666667,1
39007,6,13,19,"[1990, 1994, 1998, 2000, 2000, 2002, 2004, 2004, 2006, 2008, 2008, 2010, 2012, 2012, 2014, 2016, 2016, 2018, 2020, 2020]",2.5789473684210527,0.10829365589900916,Low Gender Representation not Detected,0.3157894736842105,3
39017,8,10,18,"[1992, 1992, 1994, 1996, 1996, 1998, 2000, 2000, 2002, 2004, 2004, 2004, 2006, 2010, 2016, 2016, 2018, 2020, 2020]",0.2222222222222222,0.6373518882339371,Low Gender Representation not Detected,0.4444444444444444,4
39023,2,16,18,"[1998, 2000, 2000, 2002, 2004, 2004, 2006, 2008, 2008, 2010, 2012, 2012, 2014, 2016, 2016, 2018, 2020, 2020]",10.88888888888889,0.0009674284502477464,Low Gender Representation,0.1111111111111111,1
39025,7,15,22,"[1990, 1994, 1996, 1996, 1998, 2000, 2000, 2004, 2004, 2006, 2008, 2008, 2010, 2012, 2012, 2012, 2014, 2016, 2016, 2018, 2020, 2020]",2.909090909090909,0.08808151166219025,Low Gender Representation not Detected,0.3181818181818182,3
39029,1,8,9,"[1996, 2012, 2012, 2014, 2016, 2016, 2018, 2020, 2020]",5.444444444444445,0.019630657257290702,Low Gender Representation,0.1111111111111111,1
39035,16,44,60,"[1990, 1992, 1992, 1994, 1996, 1996, 1998, 2000, 2000, 2002, 2002, 2004, 2004, 2006, 2008, 2008, 2010, 2010, 2010, 2010, 2010, 2010, 2010, 2010, 2010, 2010, 2010, 2012, 2012, 2012, 2012, 2012, 2014, 2014, 2014, 2014, 2014, 2014, 2014, 2016, 2016, 2016, 2016, 2016, 2017, 2018, 2018, 2018, 2018, 2018, 2018, 2018, 2018, 2020, 2020, 2020, 2020, 2020, 2021, 2021]",13.066666666666666,0.00030059760744045053,Low Gender Representation,0.26666666666666666,3
39041,5,19,24,"[1990, 1992, 1992, 1994, 1996, 1996, 1998, 2000, 2000, 2002, 2004, 2004, 2006, 2008, 2008, 2010, 2012, 2012, 2014, 2016, 2016, 2018, 2020, 2020]",8.166666666666666,0.004266724822176128,Low Gender Representation,0.20833333333333334,2
39045,3,14,17,"[2000, 2000, 2002, 2004, 2004, 2006, 2008, 2008, 2010, 2012, 2012, 2014, 2016, 2016, 2018, 2020, 2020]",7.117647058823529,0.007632881787792295,Low Gender Representation,0.17647058823529413,2
39049,16,10,26,"[1990, 1992, 1992, 1994, 1996, 1996, 1998, 2000, 2000, 2002, 2004, 2004, 2006, 2008, 2008, 2010, 2012, 2012, 2014, 2016, 2016, 2018, 2020, 2020, 2021, 2021]",1.3846153846153846,0.23931654122149193,Low Gender Representation not Detected,0.6153846153846154,6
39057,5,17,22,"[1990, 1992, 1992, 1994, 1996, 1996, 1998, 2000, 2000, 2002, 2004, 2004, 2006, 2008, 2008, 2010, 2012, 2012, 2014, 2016, 2016, 2018, 2020, 2020]",6.545454545454546,0.010515245935858921,Low Gender Representation,0.22727272727272727,2
39061,7,20,27,"[1990, 1990, 1992, 1992, 1992, 1994, 1996, 1996, 1998, 2000, 2000, 2002, 2004, 2004, 2006, 2008, 2008, 2010, 2012, 2012, 2014, 2016, 2016, 2018, 2020, 2020, 2020]",6.2592592592592595,0.01235458501787193,Low Gender Representation,0.25925925925925924,3
39085,1,8,9,"[1990, 1992, 1992, 2014, 2016, 2016, 2018, 2020, 2020]",5.444444444444445,0.019630657257290702,Low Gender Representation,0.1111111111111111,1
39089,2,15,17,"[2000, 2000, 2002, 2004, 2004, 2006, 2008, 2008, 2010, 2012, 2012, 2014, 2016, 2016, 2018, 2020, 2020]",9.941176470588236,0.0016162222150599877,Low Gender Representation,0.11764705882352941,1
39093,12,11,23,"[1990, 1992, 1992, 1996, 1996, 1998, 2000, 2000, 2002, 2004, 2004, 2006, 2008, 2008, 2010, 2012, 2012, 2014, 2016, 2016, 2018, 2020, 2020]",0.043478260869565216,0.8348273291852392,Low Gender Representation not Detected,0.5217391304347826,5
39095,8,11,19,"[1992, 1992, 2000, 2000, 2002, 2004, 2004, 2006, 2008, 2008, 2010, 2012, 2012, 2014, 2016, 2016, 2018, 2020, 2020]",0.47368421052631576,0.4912971242158932,Low Gender Representation not Detected,0.42105263157894735,4
39099,3,9,12,"[2004, 2006, 2008, 2010, 2012, 2014, 2016, 2016, 2018, 2018, 2020, 2020]",3.0,0.08326451666355042,Low Gender Representation not Detected,0.25,2
39103,4,8,12,"[1990, 2008, 2008, 2010, 2012, 2012, 2014, 2016, 2016, 2018, 2020, 2020]",1.3333333333333333,0.24821307898992026,Low Gender Representation not Detected,0.3333333333333333,3
39109,0,13,13,"[2006, 2008, 2008, 2010, 2012, 2012, 2014, 2016, 2016, 2018, 2020, 2020, 2020]",13.0,0.0003114909767673841,Low Gender Representation,0.0,0
39113,16,10,26,"[1990, 1992, 1992, 1994, 1994, 1996, 1996, 1998, 2000, 2000, 2002, 2004, 2004, 2006, 2008, 2008, 2010, 2012, 2012, 2014, 2016, 2016, 2018, 2018, 2020, 2020]",1.3846153846153846,0.23931654122149193,Low Gender Representation not Detected,0.6153846153846154,6
39133,12,12,24,"[1990, 1992, 1992, 1994, 1996, 1996, 1998, 2000, 2000, 2002, 2004, 2004, 2006, 2008, 2008, 2010, 2012, 2012, 2014, 2016, 2016, 2018, 2020, 2020]",0.0,1.0,Low Gender Representation not Detected,0.5,5
39139,1,4,5,"[2016, 2016, 2018, 2020, 2020]",1.8,0.17971249487899593,Low Gender Representation not Detected,0.2,2
39151,9,14,23,"[1992, 1992, 1994, 1996, 1996, 1998, 2000, 2000, 2002, 2004, 2004, 2006, 2008, 2008, 2010, 2012, 2012, 2014, 2016, 2016, 2018, 2020, 2020]",1.0869565217391304,0.2971465303484674,Low Gender Representation not Detected,0.391304347826087,4
39153,28,52,80,"[1990, 1990, 1990, 1992, 1992, 1992, 1992, 1992, 1992, 1992, 1992, 1994, 1994, 1994, 1998, 1998, 1998, 2000, 2000, 2000, 2000, 2000, 2000, 2000, 2000, 2002, 2002, 2002, 2004, 2004, 2004, 2004, 2004, 2004, 2004, 2004, 2006, 2006, 2006, 2008, 2008, 2008, 2008, 2008, 2008, 2008, 2008, 2010, 2011, 2012, 2012, 2012, 2012, 2012, 2012, 2012, 2012, 2012, 2014, 2016, 2016, 2016, 2016, 2016, 2016, 2016, 2016, 2016, 2016, 2018, 2018, 2020, 2020, 2020, 2020, 2020, 2020, 2020, 2020, 2020]",7.2,0.0072903580915356595,Low Gender Representation,0.35,4
39155,1,21,22,"[1990, 1992, 1992, 1994, 1996, 1996, 1998, 2000, 2000, 2002, 2004, 2006, 2008, 2008, 2010, 2012, 2012, 2014, 2016, 2016, 2018, 2020]",18.181818181818183,2.007865612426481e-05,Low Gender Representation,0.045454545454545456,0
39165,6,10,16,"[1990, 1994, 1996, 1996, 1998, 2000, 2000, 2002, 2004, 2004, 2006, 2008, 2008, 2016, 2016, 2018, 2020, 2020]",1.0,0.31731050786291115,Low Gender Representation not Detected,0.375,4
39169,5,6,11,"[2008, 2008, 2010, 2012, 2012, 2014, 2016, 2016, 2018, 2020, 2020]",0.09090909090909091,0.763024600552995,Low Gender Representation not Detected,0.45454545454545453,5
39173,2,19,21,"[1994, 1996, 1996, 1998, 2000, 2000, 2002, 2004, 2004, 2006, 2008, 2008, 2010, 2012, 2012, 2014, 2016, 2016, 2018, 2020, 2020]",13.761904761904763,0.0002075015940618336,Low Gender Representation,0.09523809523809523,1
40017,0,2,2,"[2018, 2018]",2.0,0.15729920705028105,Low Gender Representation not Detected,0.0,0
40027,2,14,16,"[1990, 1990, 1990, 1994, 1996, 1998, 1998, 2000, 2002, 2004, 2006, 2010, 2014, 2018, 2018, 2020]",9.0,0.0026997960632601883,Low Gender Representation,0.125,1
40031,0,3,3,"[2016, 2018, 2018]",3.0,0.08326451666355042,Low Gender Representation not Detected,0.0,0
40109,2,3,5,"[2014, 2014, 2018, 2018, 2020]",0.2,0.6547208460185768,Low Gender Representation not Detected,0.4,4
40143,2,1,3,"[2016, 2018, 2020]",0.3333333333333333,0.5637028616507731,Low Gender Representation not Detected,0.6666666666666666,7
41005,8,12,20,"[1990, 1992, 1992, 1994, 1996, 1996, 2000, 2000, 2002, 2004, 2004, 2006, 2008, 2008, 2010, 2010, 2012, 2012, 2016, 2020]",0.8,0.37109336952269756,Low Gender Representation not Detected,0.4,4
41017,3,15,18,"[1998, 1998, 2000, 2002, 2002, 2004, 2006, 2006, 2008, 2010, 2010, 2012, 2014, 2014, 2016, 2018, 2018, 2020]",8.0,0.004677734981047276,Low Gender Representation,0.16666666666666666,2
41019,0,2,2,"[2006, 2018]",2.0,0.15729920705028105,Low Gender Representation not Detected,0.0,0
41029,2,10,12,"[2006, 2006, 2008, 2010, 2010, 2012, 2014, 2014, 2016, 2018, 2018, 2020]",5.333333333333333,0.020921335337794035,Low Gender Representation,0.16666666666666666,2
41039,9,24,33,"[1996, 1996, 1998, 1998, 1998, 2000, 2000, 2002, 2002, 2002, 2004, 2004, 2004, 2006, 2006, 2006, 2008, 2008, 2010, 2010, 2010, 2012, 2012, 2014, 2014, 2014, 2016, 2016, 2018, 2018, 2018, 2020, 2020]",6.818181818181818,0.009023438818080326,Low Gender Representation,0.2727272727272727,3
41043,1,17,18,"[1998, 2000, 2000, 2002, 2004, 2004, 2006, 2008, 2008, 2010, 2012, 2012, 2014, 2016, 2016, 2018, 2020, 2020]",14.222222222222221,0.000162440845186801,Low Gender Representation,0.05555555555555555,1
41047,10,11,21,"[1990, 1990, 1992, 1994, 1994, 1996, 1998, 1998, 2000, 2002, 2002, 2004, 2006, 2006, 2008, 2010, 2010, 2016, 2018, 2018, 2020]",0.047619047619047616,0.8272593465627113,Low Gender Representation not Detected,0.47619047619047616,5
41051,33,9,42,"[1994, 1994, 1996, 1996, 1996, 1998, 1998, 1998, 1998, 2000, 2000, 2000, 2001, 2001, 2001, 2002, 2002, 2004, 2004, 2004, 2006, 2006, 2008, 2008, 2008, 2010, 2010, 2012, 2012, 2012, 2013, 2014, 2014, 2014, 2016, 2016, 2016, 2018, 2018, 2020, 2020, 2020]",13.714285714285714,0.00021282941901437717,Low Gender Representation,0.7857142857142857,8
41067,3,16,19,"[1998, 1998, 1998, 2000, 2000, 2002, 2002, 2002, 2004, 2004, 2006, 2006, 2006, 2008, 2008, 2010, 2010, 2018, 2020]",8.894736842105264,0.002859938208464095,Low Gender Representation,0.15789473684210525,2
41071,2,2,4,"[2008, 2010, 2012, 2014]",0.0,1.0,Low Gender Representation not Detected,0.5,5
42001,2,5,7,"[2003, 2007, 2007, 2019, 2019, 2019, 2019]",1.2857142857142858,0.2568392579578533,Low Gender Representation not Detected,0.2857142857142857,3
42003,28,81,109,"[1991, 1999, 1999, 1999, 1999, 1999, 1999, 1999, 1999, 1999, 1999, 1999, 1999, 1999, 1999, 1999, 2001, 2001, 2001, 2001, 2001, 2001, 2001, 2002, 2003, 2003, 2003, 2003, 2003, 2003, 2003, 2003, 2003, 2003, 2005, 2005, 2005, 2005, 2005, 2005, 2006, 2006, 2006, 2007, 2007, 2007, 2007, 2007, 2007, 2007, 2007, 2007, 2007, 2007, 2008, 2009, 2009, 2009, 2009, 2009, 2009, 2009, 2011, 2011, 2011, 2011, 2011, 2011, 2011, 2011, 2011, 2013, 2013, 2013, 2013, 2013, 2013, 2015, 2015, 2015, 2015, 2015, 2015, 2015, 2015, 2015, 2017, 2017, 2017, 2017, 2017, 2017, 2019, 2019, 2019, 2019, 2019, 2019, 2019, 2019, 2019, 2019, 2019, 2019, 2019, 2021, 2021, 2021, 2021, 2021, 2021]",25.770642201834864,3.844926410497442e-07,Low Gender Representation,0.25688073394495414,3
42007,4,13,17,"[1991, 1991, 1991, 1995, 1995, 1995, 1999, 1999, 1999, 2003, 2007, 2011, 2015, 2019, 2019, 2019, 2019, 2019]",4.764705882352941,0.029049022161940597,Low Gender Representation,0.23529411764705882,2
42011,3,14,17,"[1991, 1991, 1991, 1995, 1995, 1995, 1999, 1999, 1999, 2003, 2007, 2011, 2015, 2019, 2019, 2019, 2019]",7.117647058823529,0.007632881787792295,Low Gender Representation,0.17647058823529413,2
42013,3,13,16,"[1991, 1991, 1995, 1995, 1999, 1999, 2003, 2003, 2003, 2007, 2011, 2015, 2019, 2019, 2019, 2019, 2019]",6.25,0.01241933065155227,Low Gender Representation,0.1875,2
42015,1,4,5,"[2003, 2007, 2011, 2015, 2019]",1.8,0.17971249487899593,Low Gender Representation not Detected,0.2,2
42017,3,11,14,"[1991, 1991, 1991, 1995, 1995, 1995, 1999, 2003, 2007, 2011, 2015, 2019, 2019, 2019, 2019, 2019]",4.571428571428571,0.032509444645719456,Low Gender Representation,0.21428571428571427,2
42019,3,4,7,"[2003, 2007, 2011, 2015, 2019, 2019, 2019]",0.14285714285714285,0.7054569861112734,Low Gender Representation not Detected,0.42857142857142855,4
42021,0,15,15,"[2003, 2003, 2003, 2007, 2007, 2007, 2011, 2011, 2011, 2015, 2015, 2015, 2019, 2019, 2019]",15.0,0.00010751117672950066,Low Gender Representation,0.0,0
42025,0,5,5,"[2003, 2007, 2011, 2015, 2019]",5.0,0.025347318677468325,Low Gender Representation,0.0,0
42027,0,6,6,"[1999, 2003, 2007, 2011, 2015, 2019]",6.0,0.014305878435429641,Low Gender Representation,0.0,0
42029,7,9,16,"[1991, 1991, 1991, 1995, 1995, 1995, 1999, 1999, 1999, 1999, 2003, 2007, 2011, 2015, 2019, 2019, 2019, 2019]",0.25,0.6170750774519739,Low Gender Representation not Detected,0.4375,4
42037,0,4,4,"[2007, 2011, 2015, 2019]",4.0,0.04550026389635857,Low Gender Representation,0.0,0
42041,1,4,5,"[2007, 2011, 2015, 2019, 2019]",1.8,0.17971249487899593,Low Gender Representation not Detected,0.2,2
42043,1,10,11,"[1995, 1995, 1995, 1999, 1999, 1999, 2003, 2007, 2011, 2015, 2019]",7.363636363636363,0.006655605482949389,Low Gender Representation,0.09090909090909091,1
42045,8,11,19,"[1991, 1991, 1991, 1995, 1995, 1995, 1999, 1999, 1999, 2003, 2005, 2007, 2009, 2011, 2013, 2015, 2017, 2019, 2021]",0.47368421052631576,0.4912971242158932,Low Gender Representation not Detected,0.42105263157894735,4
42049,10,31,41,"[1997, 2001, 2001, 2001, 2003, 2003, 2003, 2003, 2005, 2005, 2005, 2006, 2007, 2007, 2007, 2007, 2009, 2009, 2009, 2011, 2011, 2011, 2011, 2013, 2013, 2013, 2015, 2015, 2015, 2015, 2017, 2017, 2017, 2017, 2019, 2019, 2019, 2019, 2021, 2021, 2021]",10.75609756097561,0.001039363099133526,Low Gender Representation,0.24390243902439024,2
42051,0,11,11,"[1999, 1999, 1999, 2003, 2007, 2011, 2015, 2019, 2019, 2019, 2019]",11.0,0.0009111188771537126,Low Gender Representation,0.0,0
42055,1,3,4,"[2019, 2019, 2019, 2019]",1.0,0.31731050786291115,Low Gender Representation not Detected,0.25,2
42069,1,17,18,"[1991, 1991, 1991, 1995, 1995, 1995, 1999, 1999, 1999, 2003, 2005, 2007, 2011, 2015, 2019, 2019, 2019, 2019]",14.222222222222221,0.000162440845186801,Low Gender Representation,0.05555555555555555,1
42071,0,13,13,"[1991, 1991, 1991, 1995, 1995, 1995, 2003, 2007, 2011, 2015, 2019, 2019, 2019]",13.0,0.0003114909767673841,Low Gender Representation,0.0,0
42075,5,11,16,"[1991, 1991, 1991, 1995, 1995, 1995, 1999, 1999, 1999, 2003, 2003, 2003, 2007, 2011, 2015, 2019]",2.25,0.13361440253771584,Low Gender Representation not Detected,0.3125,3
42077,2,42,44,"[2001, 2001, 2001, 2001, 2001, 2003, 2005, 2005, 2005, 2005, 2005, 2007, 2008, 2009, 2009, 2009, 2009, 2009, 2011, 2013, 2013, 2013, 2013, 2013, 2015, 2017, 2017, 2017, 2017, 2017, 2019, 2019, 2019, 2019, 2019, 2019, 2019, 2019, 2019, 2021, 2021, 2021, 2021, 2021]",36.36363636363637,1.6372964502968503e-09,Low Gender Representation,0.045454545454545456,0
42079,5,9,14,"[2007, 2007, 2011, 2013, 2015, 2017, 2019, 2019, 2019, 2019, 2019, 2019, 2020, 2021]",1.1428571428571428,0.28504940740260964,Low Gender Representation not Detected,0.35714285714285715,4
42081,0,4,4,"[2019, 2019, 2019, 2019]",4.0,0.04550026389635857,Low Gender Representation,0.0,0
42085,5,19,24,"[2007, 2011, 2015, 2017, 2017, 2017, 2017, 2017, 2017, 2017, 2017, 2017, 2017, 2017, 2017, 2017, 2017, 2017, 2017, 2017, 2017, 2017, 2017, 2019, 2019]",8.166666666666666,0.004266724822176128,Low Gender Representation,0.20833333333333334,2
42089,5,9,14,"[1991, 1991, 1991, 1995, 1995, 1995, 1999, 1999, 1999, 2003, 2007, 2011, 2015, 2019]",1.1428571428571428,0.28504940740260964,Low Gender Representation not Detected,0.35714285714285715,4
42091,3,14,17,"[1991, 1991, 1995, 1995, 1999, 1999, 2003, 2003, 2007, 2007, 2011, 2011, 2015, 2015, 2017, 2019, 2019]",7.117647058823529,0.007632881787792295,Low Gender Representation,0.17647058823529413,2
42095,16,47,63,"[1991, 1991, 1991, 1991, 2001, 2001, 2001, 2001, 2001, 2003, 2003, 2003, 2003, 2005, 2005, 2005, 2005, 2005, 2006, 2006, 2006, 2006, 2006, 2007, 2007, 2007, 2007, 2008, 2008, 2008, 2009, 2009, 2009, 2009, 2009, 2011, 2011, 2011, 2011, 2013, 2013, 2013, 2013, 2013, 2015, 2015, 2015, 2015, 2017, 2017, 2017, 2017, 2017, 2019, 2019, 2019, 2019, 2019, 2021, 2021, 2021, 2021, 2021]",15.253968253968255,9.39790952745936e-05,Low Gender Representation,0.25396825396825395,3
42097,0,4,4,"[2007, 2011, 2015, 2019]",4.0,0.04550026389635857,Low Gender Representation,0.0,0
42103,0,7,7,"[1999, 2003, 2007, 2011, 2015, 2018, 2019]",7.0,0.008150971593502705,Low Gender Representation,0.0,0
42107,0,5,5,"[2003, 2007, 2011, 2015, 2019]",5.0,0.025347318677468325,Low Gender Representation,0.0,0
42125,1,5,6,"[2003, 2007, 2011, 2015, 2019, 2019]",2.6666666666666665,0.10247043485974942,Low Gender Representation not Detected,0.16666666666666666,2
42127,0,4,4,"[2007, 2011, 2015, 2019]",4.0,0.04550026389635857,Low Gender Representation,0.0,0
42129,2,16,18,"[1991, 1991, 1991, 1995, 1995, 1995, 1999, 1999, 1999, 2003, 2004, 2007, 2011, 2015, 2019, 2019, 2019, 2019]",10.88888888888889,0.0009674284502477464,Low Gender Representation,0.1111111111111111,1
42133,5,6,11,"[1995, 1995, 1995, 1999, 1999, 1999, 2003, 2007, 2011, 2015, 2019]",0.09090909090909091,0.763024600552995,Low Gender Representation not Detected,0.45454545454545453,5
45003,8,29,37,"[1996, 1996, 1996, 1996, 1998, 1998, 1998, 1998, 2000, 2000, 2000, 2000, 2002, 2002, 2002, 2002, 2004, 2004, 2004, 2004, 2006, 2006, 2006, 2006, 2016, 2016, 2016, 2016, 2016, 2018, 2018, 2018, 2018, 2020, 2020, 2020, 2020, 2020]",11.91891891891892,0.0005556671828002371,Low Gender Representation,0.21621621621621623,2
45007,16,47,63,"[1996, 1996, 1996, 1996, 1996, 1998, 1998, 1998, 1998, 1998, 2000, 2000, 2000, 2000, 2000, 2000, 2000, 2002, 2002, 2002, 2002, 2002, 2002, 2002, 2004, 2004, 2004, 2004, 2004, 2004, 2004, 2006, 2006, 2006, 2006, 2006, 2006, 2006, 2016, 2016, 2016, 2016, 2016, 2016, 2016, 2016, 2016, 2016, 2018, 2018, 2018, 2018, 2018, 2018, 2018, 2018, 2018, 2018, 2018, 2020, 2020, 2020, 2020, 2020, 2020, 2020]",15.253968253968255,9.39790952745936e-05,Low Gender Representation,0.25396825396825395,3
45013,9,52,61,"[1996, 1996, 1996, 1996, 1996, 1998, 1998, 1998, 1998, 1998, 1998, 2000, 2000, 2000, 2000, 2000, 2002, 2002, 2002, 2002, 2002, 2002, 2002, 2002, 2004, 2004, 2004, 2004, 2006, 2006, 2006, 2006, 2006, 2006, 2006, 2010, 2014, 2016, 2016, 2016, 2016, 2016, 2016, 2016, 2016, 2016, 2018, 2018, 2018, 2018, 2018, 2018, 2018, 2018, 2018, 2018, 2018, 2018, 2018, 2020, 2020, 2020, 2020]",30.311475409836067,3.679426255857092e-08,Low Gender Representation,0.14754098360655737,1
45015,9,45,54,"[1990, 1990, 1990, 1990, 1990, 1992, 1992, 1994, 1994, 1994, 1994, 1994, 1996, 1996, 1996, 1998, 1998, 1998, 1998, 1998, 2000, 2000, 2000, 2000, 2002, 2002, 2002, 2002, 2002, 2004, 2004, 2004, 2006, 2006, 2006, 2006, 2006, 2006, 2016, 2016, 2016, 2016, 2016, 2016, 2018, 2018, 2018, 2018, 2018, 2018, 2018, 2018, 2018, 2018, 2018, 2018, 2018, 2018, 2020, 2020, 2020]",24.0,9.63357008643095e-07,Low Gender Representation,0.16666666666666666,2
45019,11,47,58,"[1996, 1996, 1996, 1996, 1998, 1998, 1998, 1998, 1998, 2000, 2000, 2000, 2000, 2002, 2002, 2002, 2002, 2002, 2004, 2004, 2004, 2004, 2006, 2006, 2006, 2006, 2006, 2008, 2008, 2008, 2008, 2010, 2010, 2010, 2010, 2010, 2011, 2012, 2012, 2012, 2012, 2014, 2014, 2014, 2014, 2014, 2016, 2016, 2016, 2016, 2018, 2018, 2018, 2018, 2018, 2020, 2020, 2020, 2020]",22.344827586206897,2.278258403619675e-06,Low Gender Representation,0.1896551724137931,2
45035,2,43,45,"[1996, 1996, 1996, 1998, 1998, 1998, 1998, 2000, 2000, 2000, 2002, 2002, 2002, 2002, 2004, 2004, 2004, 2006, 2006, 2006, 2006, 2008, 2008, 2008, 2010, 2010, 2010, 2010, 2012, 2012, 2012, 2014, 2014, 2014, 2014, 2016, 2016, 2016, 2018, 2018, 2018, 2018, 2020, 2020, 2020]",37.355555555555554,9.8440063099522e-10,Low Gender Representation,0.044444444444444446,0
45041,7,60,67,"[1996, 1996, 1996, 1996, 1998, 1998, 1998, 1998, 1998, 2000, 2000, 2000, 2000, 2002, 2002, 2002, 2002, 2002, 2004, 2004, 2004, 2004, 2006, 2006, 2006, 2006, 2006, 2008, 2008, 2008, 2008, 2010, 2010, 2010, 2010, 2010, 2012, 2012, 2012, 2012, 2014, 2014, 2014, 2014, 2014, 2016, 2016, 2016, 2016, 2016, 2016, 2016, 2016, 2018, 2018, 2018, 2018, 2018, 2018, 2018, 2018, 2018, 2018, 2018, 2018, 2018, 2020, 2020, 2020, 2020, 2020]",41.92537313432836,9.482415455138975e-11,Low Gender Representation,0.1044776119402985,1
45045,8,43,51,"[1996, 1996, 1996, 1996, 1996, 1996, 1996, 1998, 1998, 1998, 1998, 1998, 2000, 2000, 2000, 2000, 2000, 2000, 2000, 2002, 2002, 2002, 2002, 2002, 2004, 2004, 2004, 2004, 2004, 2004, 2004, 2006, 2006, 2006, 2006, 2006, 2016, 2016, 2016, 2016, 2016, 2016, 2016, 2018, 2018, 2018, 2018, 2018, 2020, 2020, 2020, 2020, 2020, 2020, 2020]",24.019607843137255,9.53596222469932e-07,Low Gender Representation,0.1568627450980392,2
45051,3,46,49,"[1996, 1996, 1996, 1996, 1996, 1998, 1998, 1998, 1998, 1998, 1998, 1998, 2000, 2000, 2000, 2000, 2000, 2002, 2002, 2002, 2002, 2002, 2002, 2004, 2004, 2004, 2004, 2004, 2006, 2006, 2006, 2006, 2006, 2006, 2008, 2016, 2016, 2016, 2016, 2016, 2018, 2018, 2018, 2018, 2018, 2018, 2020, 2020, 2020, 2020, 2020]",37.734693877551024,8.1050173209083e-10,Low Gender Representation,0.061224489795918366,1
45063,5,35,40,"[1996, 1996, 1996, 1996, 1996, 1998, 1998, 1998, 1998, 2000, 2000, 2000, 2000, 2000, 2002, 2002, 2002, 2002, 2004, 2004, 2004, 2004, 2004, 2006, 2006, 2006, 2006, 2016, 2016, 2016, 2016, 2016, 2018, 2018, 2018, 2018, 2020, 2020, 2020, 2020, 2020]",22.5,2.1014359560124407e-06,Low Gender Representation,0.125,1
45077,3,35,38,"[1996, 1996, 1996, 1996, 1998, 1998, 2000, 2000, 2000, 2000, 2002, 2002, 2004, 2004, 2004, 2004, 2006, 2006, 2008, 2008, 2008, 2008, 2010, 2010, 2012, 2012, 2012, 2012, 2014, 2014, 2016, 2016, 2016, 2016, 2018, 2018, 2020, 2020, 2020, 2020]",26.94736842105263,2.0907161196514523e-07,Low Gender Representation,0.07894736842105263,1
45079,24,47,71,"[1997, 1997, 1997, 1997, 1997, 1997, 1998, 1998, 1998, 1998, 1998, 2000, 2000, 2000, 2000, 2000, 2000, 2002, 2002, 2002, 2002, 2002, 2004, 2004, 2004, 2004, 2004, 2004, 2006, 2006, 2006, 2006, 2006, 2008, 2008, 2008, 2008, 2008, 2008, 2010, 2010, 2010, 2010, 2010, 2012, 2012, 2012, 2012, 2012, 2012, 2014, 2014, 2014, 2014, 2014, 2016, 2016, 2016, 2016, 2016, 2016, 2018, 2018, 2018, 2018, 2018, 2020, 2020, 2020, 2020, 2020, 2020]",7.450704225352113,0.006341163434776323,Low Gender Representation,0.3380281690140845,3
45083,3,24,27,"[1996, 1996, 1996, 1998, 1998, 1998, 2000, 2000, 2000, 2002, 2002, 2002, 2004, 2004, 2004, 2006, 2006, 2006, 2016, 2016, 2016, 2018, 2018, 2018, 2018, 2020, 2020, 2020]",16.333333333333332,5.312128159411727e-05,Low Gender Representation,0.1111111111111111,1
45085,11,38,49,"[1996, 1996, 1996, 1996, 1998, 1998, 1998, 2000, 2000, 2000, 2000, 2002, 2002, 2002, 2004, 2004, 2004, 2004, 2006, 2006, 2006, 2008, 2008, 2008, 2008, 2010, 2010, 2010, 2012, 2012, 2012, 2012, 2014, 2014, 2014, 2016, 2016, 2016, 2016, 2016, 2016, 2016, 2016, 2018, 2018, 2018, 2020, 2020, 2020, 2020]",14.877551020408163,0.0001147201210465605,Low Gender Representation,0.22448979591836735,2
45091,11,44,55,"[1996, 1996, 1996, 1996, 1996, 1996, 1996, 1998, 1998, 1998, 1998, 1998, 1998, 1998, 2000, 2000, 2000, 2000, 2000, 2000, 2000, 2002, 2002, 2002, 2002, 2002, 2002, 2002, 2004, 2004, 2004, 2004, 2004, 2004, 2004, 2006, 2006, 2006, 2006, 2006, 2006, 2006, 2016, 2016, 2016, 2016, 2016, 2016, 2016, 2018, 2018, 2018, 2020, 2020, 2020, 2020]",19.8,8.598267663723586e-06,Low Gender Representation,0.2,2
46099,6,4,10,"[2002, 2004, 2006, 2008, 2010, 2014, 2016, 2018, 2020, 2020]",0.4,0.5270892568655381,Low Gender Representation not Detected,0.6,6
46103,0,2,2,"[2018, 2020]",2.0,0.15729920705028105,Low Gender Representation not Detected,0.0,0
47009,13,72,85,"[2006, 2006, 2006, 2006, 2006, 2006, 2006, 2006, 2006, 2006, 2006, 2006, 2006, 2006, 2006, 2006, 2006, 2006, 2006, 2006, 2006, 2010, 2010, 2010, 2010, 2010, 2010, 2010, 2010, 2010, 2010, 2010, 2010, 2010, 2010, 2010, 2010, 2010, 2010, 2010, 2010, 2010, 2014, 2014, 2014, 2014, 2014, 2014, 2014, 2014, 2014, 2014, 2014, 2014, 2014, 2014, 2014, 2014, 2014, 2014, 2014, 2014, 2014, 2018, 2018, 2018, 2018, 2018, 2018, 2018, 2018, 2018, 2018, 2018, 2018, 2018, 2018, 2018, 2018, 2018, 2018, 2018, 2018, 2018, 2018]",40.95294117647059,1.5593915931912643e-10,Low Gender Representation,0.15294117647058825,2
47011,4,11,15,"[2012, 2014, 2014, 2014, 2014, 2014, 2014, 2014, 2014, 2014, 2014, 2014, 2014, 2014, 2014]",3.2666666666666666,0.07070114486598289,Low Gender Representation not Detected,0.26666666666666666,3
47065,4,8,12,"[2012, 2014, 2014, 2014, 2014, 2014, 2014, 2014, 2014, 2014, 2017, 2017]",1.3333333333333333,0.24821307898992026,Low Gender Representation not Detected,0.3333333333333333,3
47093,5,50,55,"[2004, 2004, 2006, 2006, 2006, 2006, 2006, 2006, 2006, 2006, 2006, 2006, 2006, 2006, 2006, 2006, 2006, 2006, 2006, 2006, 2006, 2008, 2008, 2008, 2008, 2008, 2008, 2008, 2008, 2010, 2010, 2010, 2010, 2010, 2010, 2010, 2010, 2010, 2010, 2010, 2014, 2014, 2014, 2014, 2016, 2016, 2016, 2016, 2016, 2016, 2016, 2018, 2018, 2018, 2018, 2018]",36.81818181818182,1.2967524285378033e-09,Low Gender Representation,0.09090909090909091,1
47125,9,55,64,"[2008, 2010, 2010, 2010, 2010, 2010, 2010, 2010, 2010, 2010, 2010, 2010, 2010, 2010, 2010, 2010, 2010, 2010, 2010, 2010, 2010, 2010, 2014, 2014, 2014, 2014, 2014, 2014, 2014, 2014, 2014, 2014, 2014, 2014, 2014, 2014, 2014, 2014, 2014, 2014, 2014, 2014, 2014, 2018, 2018, 2018, 2018, 2018, 2018, 2018, 2018, 2018, 2018, 2018, 2018, 2018, 2018, 2018, 2018, 2018, 2018, 2018, 2018, 2018, 2018]",33.0625,8.924344907803227e-09,Low Gender Representation,0.140625,1
47149,8,56,64,"[2010, 2010, 2010, 2010, 2010, 2010, 2010, 2010, 2010, 2010, 2010, 2010, 2010, 2010, 2010, 2010, 2010, 2010, 2010, 2010, 2010, 2014, 2014, 2014, 2014, 2014, 2014, 2014, 2014, 2014, 2014, 2014, 2014, 2014, 2014, 2014, 2014, 2014, 2014, 2014, 2014, 2014, 2018, 2018, 2018, 2018, 2018, 2018, 2018, 2018, 2018, 2018, 2018, 2018, 2018, 2018, 2018, 2018, 2018, 2018, 2018, 2018, 2018, 2018]",36.0,1.9731752900753933e-09,Low Gender Representation,0.125,1
47157,10,44,54,"[2006, 2006, 2006, 2006, 2006, 2006, 2006, 2006, 2006, 2006, 2006, 2006, 2006, 2010, 2010, 2010, 2010, 2010, 2010, 2010, 2010, 2010, 2010, 2010, 2010, 2010, 2012, 2014, 2014, 2014, 2014, 2014, 2014, 2014, 2014, 2014, 2014, 2014, 2014, 2014, 2018, 2018, 2018, 2018, 2018, 2018, 2018, 2018, 2018, 2018, 2018, 2018, 2018, 2018]",21.40740740740741,3.7133378969025538e-06,Low Gender Representation,0.18518518518518517,2
47163,12,58,70,"[2010, 2010, 2010, 2010, 2010, 2010, 2010, 2010, 2010, 2010, 2010, 2010, 2010, 2010, 2010, 2010, 2010, 2010, 2010, 2010, 2010, 2010, 2010, 2010, 2014, 2014, 2014, 2014, 2014, 2014, 2014, 2014, 2014, 2014, 2014, 2014, 2014, 2014, 2014, 2014, 2014, 2014, 2014, 2014, 2014, 2014, 2014, 2014, 2018, 2018, 2018, 2018, 2018, 2018, 2018, 2018, 2018, 2018, 2018, 2018, 2018, 2018, 2018, 2018, 2018, 2018, 2018, 2018, 2018, 2018, 2018, 2018, 2018]",30.228571428571428,3.8401056753718867e-08,Low Gender Representation,0.17142857142857143,2
47165,10,39,49,"[2014, 2014, 2014, 2014, 2014, 2014, 2014, 2014, 2014, 2014, 2014, 2014, 2014, 2014, 2014, 2014, 2014, 2014, 2014, 2014, 2014, 2014, 2014, 2014, 2018, 2018, 2018, 2018, 2018, 2018, 2018, 2018, 2018, 2018, 2018, 2018, 2018, 2018, 2018, 2018, 2018, 2018, 2018, 2018, 2018, 2018, 2018, 2018, 2018]",17.163265306122447,3.430056223401301e-05,Low Gender Representation,0.20408163265306123,2
47187,13,35,48,"[2010, 2010, 2010, 2010, 2010, 2010, 2010, 2010, 2010, 2010, 2010, 2010, 2010, 2010, 2010, 2010, 2010, 2010, 2010, 2010, 2010, 2010, 2010, 2010, 2014, 2014, 2014, 2014, 2014, 2014, 2014, 2014, 2014, 2014, 2014, 2014, 2014, 2014, 2014, 2014, 2014, 2014, 2014, 2014, 2014, 2014, 2014, 2014]",10.083333333333334,0.0014961642897455517,Low Gender Representation,0.2708333333333333,3
47189,20,56,76,"[2010, 2010, 2010, 2010, 2010, 2010, 2010, 2010, 2010, 2010, 2010, 2010, 2010, 2010, 2010, 2010, 2010, 2010, 2010, 2010, 2010, 2010, 2010, 2010, 2010, 2014, 2014, 2014, 2014, 2014, 2014, 2014, 2014, 2014, 2014, 2014, 2014, 2014, 2014, 2014, 2014, 2014, 2014, 2014, 2014, 2014, 2014, 2014, 2014, 2014, 2018, 2018, 2018, 2018, 2018, 2018, 2018, 2018, 2018, 2018, 2018, 2018, 2018, 2018, 2018, 2018, 2018, 2018, 2018, 2018, 2018, 2018, 2018, 2018, 2018, 2020]",17.05263157894737,3.635795520299535e-05,Low Gender Representation,0.2631578947368421,3
48027,0,23,23,"[2000, 2000, 2002, 2002, 2004, 2006, 2008, 2008, 2010, 2010, 2010, 2012, 2012, 2014, 2014, 2014, 2016, 2016, 2018, 2018, 2018, 2020, 2020]",23.0,1.620013982466468e-06,Low Gender Representation,0.0,0
48029,2,32,34,"[1994, 1994, 1996, 1996, 1998, 1998, 2000, 2000, 2002, 2002, 2004, 2004, 2006, 2006, 2006, 2008, 2008, 2010, 2010, 2010, 2012, 2012, 2014, 2014, 2014, 2016, 2016, 2018, 2018, 2018, 2019, 2020, 2020, 2020]",26.470588235294116,2.675813047727118e-07,Low Gender Representation,0.058823529411764705,1
48039,2,35,37,"[1990, 1990, 1990, 1992, 1992, 1994, 1994, 1994, 1996, 1996, 1998, 1998, 1998, 2000, 2000, 2002, 2002, 2002, 2004, 2004, 2006, 2006, 2006, 2008, 2008, 2010, 2010, 2010, 2012, 2012, 2014, 2014, 2014, 2016, 2016, 2018, 2018, 2018, 2020, 2020]",29.43243243243243,5.790051557115332e-08,Low Gender Representation,0.05405405405405406,1
48041,6,25,31,"[1994, 1994, 1994, 1998, 1998, 1998, 2002, 2002, 2002, 2002, 2006, 2006, 2006, 2008, 2008, 2010, 2010, 2010, 2012, 2012, 2014, 2014, 2014, 2016, 2016, 2018, 2018, 2018, 2020, 2020, 2020]",11.64516129032258,0.0006436975254696885,Low Gender Representation,0.1935483870967742,2
48061,4,12,16,"[2010, 2010, 2012, 2012, 2014, 2014, 2016, 2016, 2016, 2016, 2016, 2018, 2018, 2018, 2020, 2020]",4.0,0.04550026389635857,Low Gender Representation,0.25,2
48085,6,13,19,"[2006, 2008, 2008, 2008, 2010, 2010, 2012, 2012, 2014, 2014, 2014, 2016, 2016, 2018, 2018, 2018, 2018, 2020, 2020]",2.5789473684210527,0.10829365589900916,Low Gender Representation not Detected,0.3157894736842105,3
48091,11,15,26,"[1992, 1994, 1996, 1996, 2000, 2000, 2002, 2002, 2002, 2004, 2004, 2008, 2008, 2010, 2010, 2010, 2012, 2012, 2014, 2014, 2014, 2016, 2016, 2018, 2018, 2018]",0.6153846153846154,0.43276758066778465,Low Gender Representation not Detected,0.4230769230769231,4
48113,10,23,33,"[1990, 1990, 1992, 1992, 1996, 1996, 2000, 2000, 2002, 2002, 2002, 2004, 2004, 2006, 2006, 2006, 2008, 2008, 2010, 2010, 2010, 2012, 2012, 2014, 2014, 2014, 2016, 2016, 2018, 2018, 2018, 2020, 2020]",5.121212121212121,0.02363510198283392,Low Gender Representation,0.30303030303030304,3
48121,8,16,24,"[1990, 1990, 1990, 1992, 1992, 2006, 2006, 2008, 2008, 2010, 2010, 2010, 2012, 2012, 2014, 2014, 2014, 2016, 2016, 2018, 2018, 2018, 2020, 2020]",2.6666666666666665,0.10247043485974942,Low Gender Representation not Detected,0.3333333333333333,3
48135,0,1,1,[2012],1.0,0.31731050786291115,Low Gender Representation not Detected,0.0,0
48139,2,13,15,"[2008, 2008, 2010, 2010, 2010, 2012, 2012, 2014, 2014, 2014, 2016, 2016, 2018, 2018, 2018]",8.066666666666666,0.004508698364904238,Low Gender Representation,0.13333333333333333,1
48141,9,23,32,"[1990, 1996, 1996, 1998, 1998, 1998, 2000, 2000, 2002, 2002, 2002, 2004, 2004, 2006, 2006, 2006, 2008, 2008, 2010, 2010, 2010, 2012, 2012, 2014, 2014, 2014, 2016, 2016, 2018, 2018, 2018, 2020]",6.125,0.01332832878081758,Low Gender Representation,0.28125,3
48157,0,20,20,"[1992, 1994, 1996, 2004, 2004, 2006, 2006, 2006, 2008, 2008, 2010, 2010, 2010, 2012, 2012, 2014, 2014, 2014, 2016, 2016, 2018, 2018, 2018, 2020, 2020]",20.0,7.744216431044088e-06,Low Gender Representation,0.0,0
48167,0,29,29,"[1992, 1992, 1994, 1994, 1994, 1996, 1998, 1998, 1998, 2000, 2006, 2006, 2006, 2008, 2008, 2010, 2010, 2010, 2012, 2014, 2014, 2014, 2016, 2016, 2018, 2018, 2018, 2020, 2020]",29.0,7.23782987174e-08,Low Gender Representation,0.0,0
48181,3,9,12,"[2004, 2004, 2006, 2006, 2006, 2008, 2008, 2010, 2010, 2010, 2012, 2016, 2016]",3.0,0.08326451666355042,Low Gender Representation not Detected,0.25,2
48183,0,10,10,"[2014, 2014, 2014, 2016, 2016, 2018, 2018, 2018, 2020, 2020]",10.0,0.001565402258002549,Low Gender Representation,0.0,0
48187,2,6,8,"[2000, 2000, 2002, 2002, 2010, 2014, 2014, 2018]",2.0,0.15729920705028105,Low Gender Representation not Detected,0.25,2
48201,3,24,27,"[1996, 1996, 1998, 1998, 2000, 2000, 2002, 2002, 2004, 2004, 2006, 2006, 2008, 2008, 2010, 2010, 2012, 2012, 2014, 2014, 2016, 2016, 2016, 2018, 2018, 2018, 2020, 2020]",16.333333333333332,5.312128159411727e-05,Low Gender Representation,0.1111111111111111,1
48209,10,23,33,"[1992, 1992, 1994, 1994, 1994, 1996, 1996, 1998, 2000, 2000, 2002, 2002, 2002, 2004, 2004, 2006, 2006, 2006, 2008, 2008, 2010, 2010, 2010, 2012, 2012, 2014, 2014, 2014, 2016, 2016, 2018, 2018, 2018, 2020, 2020]",5.121212121212121,0.02363510198283392,Low Gender Representation,0.30303030303030304,3
48215,1,3,4,"[2008, 2008, 2010, 2018]",1.0,0.31731050786291115,Low Gender Representation not Detected,0.25,2
48245,0,12,12,"[1998, 1998, 1998, 2000, 2000, 2002, 2002, 2002, 2004, 2004, 2008, 2020]",12.0,0.0005320055051392492,Low Gender Representation,0.0,0
48251,0,2,2,"[2020, 2020]",2.0,0.15729920705028105,Low Gender Representation not Detected,0.0,0
48257,0,2,2,"[2020, 2020]",2.0,0.15729920705028105,Low Gender Representation not Detected,0.0,0
48303,4,23,27,"[2000, 2000, 2002, 2002, 2002, 2004, 2004, 2006, 2006, 2006, 2008, 2008, 2010, 2010, 2010, 2012, 2012, 2014, 2014, 2014, 2016, 2016, 2018, 2018, 2018, 2020, 2020]",13.37037037037037,0.0002556308678365151,Low Gender Representation,0.14814814814814814,1
48309,1,15,16,"[2008, 2010, 2010, 2010, 2012, 2012, 2014, 2014, 2014, 2016, 2016, 2018, 2018, 2018, 2020, 2020]",12.25,0.0004652581580710503,Low Gender Representation,0.0625,1
48329,1,6,7,"[2004, 2006, 2008, 2012, 2016, 2016, 2018]",3.5714285714285716,0.05878172135535891,Low Gender Representation not Detected,0.14285714285714285,1
48339,0,37,37,"[1990, 1990, 1992, 1992, 1994, 1994, 1994, 1996, 1996, 1998, 1998, 1998, 2000, 2000, 2002, 2002, 2002, 2006, 2006, 2006, 2008, 2008, 2010, 2010, 2010, 2012, 2012, 2014, 2014, 2014, 2016, 2016, 2018, 2018, 2018, 2020, 2020]",37.0,1.1812924646610715e-09,Low Gender Representation,0.0,0
48355,5,23,28,"[2000, 2000, 2002, 2002, 2002, 2004, 2004, 2006, 2006, 2006, 2008, 2008, 2010, 2010, 2010, 2012, 2012, 2014, 2014, 2014, 2016, 2016, 2018, 2018, 2018, 2018, 2020, 2020]",11.571428571428571,0.0006697294490218293,Low Gender Representation,0.17857142857142858,2
48367,0,5,5,"[2010, 2010, 2010, 2012, 2012]",5.0,0.025347318677468325,Low Gender Representation,0.0,0
48381,4,35,39,"[1990, 1990, 1990, 1992, 1992, 1994, 1994, 1994, 1996, 1996, 1998, 1998, 1998, 2000, 2000, 2002, 2002, 2002, 2004, 2004, 2006, 2006, 2008, 2008, 2010, 2010, 2010, 2012, 2012, 2014, 2014, 2014, 2016, 2016, 2018, 2018, 2018, 2020, 2020]",24.641025641025642,6.906563164693732e-07,Low Gender Representation,0.10256410256410256,1
48423,2,8,10,"[2012, 2012, 2014, 2014, 2014, 2018, 2018, 2018, 2020, 2020]",3.6,0.05777957112359715,Low Gender Representation not Detected,0.2,2
48439,8,29,37,"[1990, 1992, 1992, 1994, 1994, 1996, 1996, 1998, 1998, 1998, 2000, 2000, 2002, 2002, 2002, 2004, 2004, 2006, 2006, 2006, 2008, 2008, 2010, 2010, 2010, 2012, 2012, 2014, 2014, 2014, 2016, 2016, 2018, 2018, 2018, 2020, 2020]",11.91891891891892,0.0005556671828002371,Low Gender Representation,0.21621621621621623,2
48441,0,5,5,"[2018, 2018, 2018, 2020, 2020]",5.0,0.025347318677468325,Low Gender Representation,0.0,0
48451,1,7,8,"[2008, 2008, 2010, 2012, 2014, 2014, 2014, 2018]",4.5,0.033894853524689295,Low Gender Representation,0.125,1
48453,20,24,44,"[1990, 1990, 1990, 1992, 1992, 1992, 1994, 1994, 1996, 1996, 1998, 1998, 1998, 1998, 1998, 2000, 2000, 2002, 2002, 2002, 2002, 2004, 2004, 2006, 2006, 2006, 2008, 2008, 2010, 2010, 2010, 2012, 2012, 2014, 2014, 2014, 2016, 2016, 2018, 2018, 2018, 2020, 2020, 2020]",0.36363636363636365,0.5464935954065822,Low Gender Representation not Detected,0.45454545454545453,5
48479,1,6,7,"[2002, 2002, 2004, 2004, 2006, 2016, 2018]",3.5714285714285716,0.05878172135535891,Low Gender Representation not Detected,0.14285714285714285,1
48491,10,19,29,"[1990, 1990, 1992, 1992, 1994, 1994, 1994, 1996, 1996, 1998, 1998, 1998, 2004, 2004, 2008, 2008, 2010, 2010, 2012, 2014, 2014, 2014, 2016, 2016, 2018, 2018, 2018, 2020, 2020]",2.793103448275862,0.09467071984550879,Low Gender Representation not Detected,0.3448275862068966,3
49005,5,24,29,"[2006, 2006, 2006, 2008, 2008, 2008, 2008, 2010, 2010, 2010, 2012, 2012, 2012, 2012, 2014, 2014, 2014, 2016, 2016, 2016, 2016, 2018, 2018, 2018, 2018, 2020, 2020, 2020, 2020]",12.448275862068966,0.00041837784586464276,Low Gender Representation,0.1724137931034483,2
49011,8,14,22,"[1992, 1994, 1994, 1996, 1998, 1998, 2000, 2002, 2002, 2004, 2006, 2006, 2008, 2010, 2010, 2012, 2014, 2014, 2016, 2018, 2018, 2020]",1.6363636363636365,0.2008251226951417,Low Gender Representation not Detected,0.36363636363636365,4
49035,13,48,61,"[1990, 1990, 1992, 1994, 1994, 1996, 1998, 1998, 2000, 2000, 2000, 2000, 2000, 2000, 2000, 2000, 2000, 2002, 2002, 2002, 2002, 2004, 2004, 2004, 2004, 2006, 2006, 2006, 2006, 2008, 2008, 2008, 2008, 2010, 2010, 2010, 2010, 2012, 2012, 2012, 2012, 2014, 2014, 2014, 2014, 2016, 2016, 2016, 2016, 2016, 2018, 2018, 2018, 2018, 2018, 2018, 2019, 2020, 2020, 2020, 2020]",20.081967213114755,7.419293713577076e-06,Low Gender Representation,0.21311475409836064,2
49049,0,17,17,"[1998, 1998, 2000, 2002, 2002, 2004, 2006, 2006, 2008, 2010, 2010, 2012, 2014, 2014, 2016, 2018, 2018, 2020]",17.0,3.737981840170153e-05,Low Gender Representation,0.0,0
49053,0,4,4,"[2016, 2018, 2018, 2020]",4.0,0.04550026389635857,Low Gender Representation,0.0,0
49057,2,18,20,"[1994, 1994, 1996, 1998, 1998, 2002, 2002, 2004, 2006, 2006, 2008, 2010, 2010, 2012, 2014, 2014, 2016, 2018, 2018, 2020]",12.8,0.000346619351134667,Low Gender Representation,0.1,1
51003,17,19,36,"[1993, 1997, 2001, 2001, 2001, 2003, 2003, 2003, 2005, 2005, 2005, 2007, 2007, 2007, 2009, 2009, 2009, 2011, 2011, 2011, 2013, 2013, 2013, 2013, 2015, 2015, 2015, 2017, 2017, 2017, 2019, 2019, 2019, 2021, 2021, 2021]",0.1111111111111111,0.7388826803635273,Low Gender Representation not Detected,0.4722222222222222,5
51013,11,22,33,"[1989, 1990, 1990, 1991, 1991, 1995, 1995, 1999, 1999, 2000, 2001, 2002, 2003, 2003, 2004, 2005, 2006, 2007, 2008, 2009, 2010, 2011, 2012, 2012, 2013, 2014, 2014, 2015, 2016, 2017, 2018, 2019, 2020, 2020, 2021]",3.6666666666666665,0.05551109809787105,Low Gender Representation not Detected,0.3333333333333333,3
51041,9,25,34,"[1995, 1995, 1995, 1995, 1995, 1999, 1999, 1999, 1999, 1999, 2003, 2003, 2003, 2003, 2003, 2007, 2007, 2007, 2007, 2007, 2011, 2011, 2011, 2011, 2011, 2015, 2015, 2015, 2015, 2015, 2019, 2019, 2019, 2019, 2019]",7.529411764705882,0.006069972362023284,Low Gender Representation,0.2647058823529412,3
51059,37,41,78,"[1991, 1991, 1991, 1991, 1991, 1991, 1991, 1991, 1991, 1991, 1995, 1995, 1995, 1995, 1995, 1995, 1995, 1995, 1995, 1995, 1995, 1999, 1999, 1999, 1999, 1999, 1999, 1999, 1999, 1999, 1999, 2003, 2003, 2003, 2003, 2003, 2003, 2003, 2003, 2003, 2003, 2007, 2007, 2007, 2007, 2007, 2007, 2007, 2007, 2007, 2009, 2009, 2011, 2011, 2011, 2011, 2011, 2011, 2011, 2011, 2011, 2015, 2015, 2015, 2015, 2015, 2015, 2015, 2015, 2015, 2015, 2019, 2019, 2019, 2019, 2019, 2019, 2019, 2019, 2019]",0.20512820512820512,0.6506129639327538,Low Gender Representation not Detected,0.47435897435897434,5
51087,8,32,40,"[1991, 1991, 1991, 1991, 1991, 1995, 1995, 1995, 1995, 1995, 1999, 1999, 1999, 1999, 1999, 2003, 2003, 2003, 2003, 2003, 2007, 2007, 2007, 2007, 2007, 2011, 2011, 2011, 2011, 2011, 2015, 2015, 2015, 2015, 2015, 2017, 2019, 2019, 2019, 2019, 2019]",14.4,0.00014780231033445398,Low Gender Representation,0.2,2
51107,22,47,69,"[1991, 1991, 1991, 1991, 1991, 1991, 1991, 1991, 1991, 1995, 1995, 1995, 1995, 1995, 1995, 1995, 1995, 1995, 1999, 1999, 1999, 1999, 1999, 1999, 1999, 1999, 1999, 2003, 2003, 2003, 2003, 2003, 2003, 2003, 2003, 2003, 2003, 2007, 2007, 2007, 2007, 2007, 2007, 2007, 2007, 2007, 2011, 2011, 2011, 2011, 2011, 2011, 2011, 2011, 2011, 2015, 2015, 2015, 2015, 2015, 2015, 2015, 2015, 2015, 2019, 2019, 2019, 2019, 2019, 2019, 2019, 2019, 2019]",9.057971014492754,0.002615520565337903,Low Gender Representation,0.3188405797101449,3
51153,25,42,67,"[1991, 1991, 1991, 1991, 1991, 1991, 1991, 1991, 1995, 1995, 1995, 1995, 1995, 1995, 1995, 1995, 1999, 1999, 1999, 1999, 1999, 1999, 1999, 1999, 2003, 2003, 2003, 2003, 2003, 2003, 2003, 2006, 2007, 2007, 2007, 2007, 2007, 2007, 2007, 2007, 2007, 2011, 2011, 2011, 2011, 2011, 2011, 2011, 2011, 2014, 2015, 2015, 2015, 2015, 2015, 2015, 2015, 2015, 2019, 2019, 2019, 2019, 2019, 2019, 2019, 2019, 2019]",4.313432835820896,0.03781258495582762,Low Gender Representation,0.373134328358209,4
51177,1,5,6,"[2017, 2017, 2019, 2019, 2019, 2019]",2.6666666666666665,0.10247043485974942,Low Gender Representation not Detected,0.16666666666666666,2
51179,7,8,15,"[2009, 2012, 2013, 2015, 2015, 2017, 2017, 2017, 2017, 2018, 2019, 2019, 2019, 2021, 2021, 2021, 2021]",0.06666666666666667,0.7962534147376392,Low Gender Representation not Detected,0.4666666666666667,5
53005,1,23,24,"[1990, 1992, 1992, 1994, 1996, 1996, 1998, 2000, 2000, 2002, 2004, 2004, 2006, 2008, 2008, 2010, 2012, 2012, 2014, 2016, 2016, 2018, 2020, 2020]",20.166666666666668,7.09790833090828e-06,Low Gender Representation,0.041666666666666664,0
53007,1,3,4,"[2016, 2016, 2020, 2020]",1.0,0.31731050786291115,Low Gender Representation not Detected,0.25,2
53009,0,4,4,"[2015, 2016, 2019, 2020]",4.0,0.04550026389635857,Low Gender Representation,0.0,0
53011,11,13,24,"[1998, 2000, 2000, 2002, 2004, 2004, 2004, 2005, 2006, 2008, 2008, 2010, 2012, 2012, 2014, 2015, 2016, 2016, 2016, 2018, 2018, 2018, 2020, 2020]",0.16666666666666666,0.6830913983096086,Low Gender Representation not Detected,0.4583333333333333,5
53015,2,15,17,"[1998, 2000, 2000, 2002, 2004, 2004, 2006, 2008, 2008, 2010, 2012, 2012, 2014, 2016, 2016, 2020, 2020]",9.941176470588236,0.0016162222150599877,Low Gender Representation,0.11764705882352941,1
53021,0,4,4,"[2016, 2016, 2020, 2020]",4.0,0.04550026389635857,Low Gender Representation,0.0,0
53025,0,4,4,"[2016, 2016, 2020, 2020]",4.0,0.04550026389635857,Low Gender Representation,0.0,0
53027,1,3,4,"[2016, 2016, 2020, 2020]",1.0,0.31731050786291115,Low Gender Representation not Detected,0.25,2
53033,24,62,86,"[1989, 1989, 1989, 1989, 1989, 1991, 1991, 1991, 1991, 1993, 1993, 1993, 1993, 1993, 1995, 1995, 1995, 1995, 1997, 1997, 1997, 1997, 1997, 1999, 1999, 1999, 1999, 2001, 2001, 2001, 2001, 2001, 2002, 2003, 2003, 2003, 2003, 2003, 2003, 2005, 2005, 2005, 2005, 2005, 2005, 2005, 2005, 2005, 2007, 2007, 2007, 2007, 2009, 2009, 2009, 2009, 2009, 2010, 2010, 2011, 2011, 2011, 2011, 2013, 2013, 2013, 2013, 2013, 2015, 2015, 2015, 2015, 2017, 2017, 2017, 2017, 2017, 2019, 2019, 2019, 2019, 2021, 2021, 2021, 2021, 2021]",16.790697674418606,4.17374032728321e-05,Low Gender Representation,0.27906976744186046,3
53035,8,10,18,"[1998, 2000, 2000, 2002, 2004, 2004, 2006, 2008, 2008, 2010, 2012, 2012, 2014, 2016, 2016, 2018, 2020, 2020]",0.2222222222222222,0.6373518882339371,Low Gender Representation not Detected,0.4444444444444444,4
53041,1,3,4,"[2016, 2016, 2020, 2020]",1.0,0.31731050786291115,Low Gender Representation not Detected,0.25,2
53045,2,7,9,"[2004, 2008, 2012, 2014, 2016, 2016, 2018, 2020, 2020]",2.7777777777777777,0.09558070454562936,Low Gender Representation not Detected,0.2222222222222222,2
53053,12,30,42,"[1998, 1998, 1998, 2000, 2000, 2000, 2000, 2002, 2002, 2002, 2004, 2004, 2004, 2004, 2006, 2006, 2006, 2008, 2008, 2008, 2008, 2010, 2010, 2010, 2012, 2012, 2012, 2012, 2014, 2014, 2014, 2016, 2016, 2016, 2016, 2018, 2018, 2018, 2020, 2020, 2020, 2020]",7.714285714285714,0.00547855324254737,Low Gender Representation,0.2857142857142857,3
53057,4,16,20,"[1994, 1996, 1996, 2000, 2000, 2002, 2004, 2004, 2006, 2008, 2008, 2010, 2012, 2012, 2014, 2016, 2016, 2018, 2020, 2020]",7.2,0.0072903580915356595,Low Gender Representation,0.2,2
53061,9,36,45,"[1991, 1991, 1993, 1993, 1993, 1995, 1995, 1997, 1997, 1997, 1999, 1999, 2001, 2001, 2001, 2003, 2003, 2005, 2005, 2005, 2007, 2007, 2009, 2009, 2009, 2011, 2011, 2013, 2013, 2013, 2015, 2015, 2016, 2016, 2017, 2017, 2017, 2019, 2019, 2019, 2019, 2019, 2020, 2021, 2021, 2021]",16.2,5.699411623331848e-05,Low Gender Representation,0.2,2
53063,8,18,26,"[1990, 1992, 1992, 1994, 1995, 1996, 1996, 1998, 2000, 2000, 2002, 2004, 2004, 2006, 2008, 2008, 2010, 2012, 2012, 2014, 2016, 2016, 2018, 2018, 2020, 2020]",3.8461538461538463,0.049860203756906855,Low Gender Representation,0.3076923076923077,3
53067,14,11,25,"[1990, 1992, 1992, 1992, 1994, 1996, 1996, 1998, 2000, 2000, 2002, 2004, 2004, 2006, 2008, 2008, 2010, 2012, 2012, 2014, 2016, 2016, 2018, 2020, 2020]",0.36,0.5485062355001471,Low Gender Representation not Detected,0.56,6
53071,1,3,4,"[2016, 2016, 2020, 2020]",1.0,0.31731050786291115,Low Gender Representation not Detected,0.25,2
53073,3,7,10,"[2017, 2017, 2017, 2017, 2018, 2019, 2021, 2021, 2021, 2021]",1.6,0.20590321073206466,Low Gender Representation not Detected,0.3,3
53077,3,12,15,"[1990, 1992, 1992, 1994, 1996, 1996, 1998, 2000, 2000, 2002, 2004, 2004, 2006, 2020, 2020]",5.4,0.02013675155034633,Low Gender Representation,0.2,2
54003,2,4,6,"[2012, 2012, 2014, 2014, 2020, 2020]",0.6666666666666666,0.4142161782425251,Low Gender Representation not Detected,0.3333333333333333,3
54039,0,3,3,"[2012, 2014, 2020]",3.0,0.08326451666355042,Low Gender Representation not Detected,0.0,0
54061,0,2,2,"[2012, 2014]",2.0,0.15729920705028105,Low Gender Representation not Detected,0.0,0
55009,8,18,26,"[2020, 2020, 2020, 2020, 2020, 2020, 2020, 2020, 2020, 2020, 2020, 2020, 2020, 2020, 2020, 2020, 2020, 2020, 2020, 2020, 2020, 2020, 2020, 2020, 2020, 2020]",3.8461538461538463,0.049860203756906855,Low Gender Representation,0.3076923076923077,3
55025,93,137,230,"[2010, 2010, 2010, 2010, 2010, 2010, 2010, 2010, 2010, 2010, 2010, 2010, 2010, 2010, 2010, 2010, 2010, 2010, 2010, 2010, 2010, 2010, 2010, 2010, 2010, 2010, 2010, 2010, 2010, 2010, 2010, 2010, 2010, 2010, 2010, 2010, 2010, 2012, 2012, 2012, 2012, 2012, 2012, 2012, 2012, 2012, 2012, 2012, 2012, 2012, 2012, 2012, 2012, 2012, 2012, 2012, 2012, 2012, 2012, 2012, 2012, 2012, 2012, 2012, 2012, 2012, 2012, 2012, 2012, 2012, 2012, 2012, 2012, 2014, 2014, 2014, 2014, 2014, 2014, 2014, 2014, 2014, 2014, 2014, 2014, 2014, 2014, 2014, 2014, 2014, 2014, 2014, 2014, 2014, 2014, 2014, 2014, 2014, 2014, 2014, 2014, 2014, 2014, 2014, 2014, 2014, 2014, 2014, 2015, 2016, 2016, 2016, 2016, 2016, 2016, 2016, 2016, 2016, 2016, 2016, 2016, 2016, 2016, 2016, 2016, 2016, 2016, 2016, 2016, 2016, 2016, 2016, 2016, 2016, 2016, 2016, 2016, 2016, 2016, 2016, 2016, 2016, 2016, 2016, 2016, 2016, 2018, 2018, 2018, 2018, 2018, 2018, 2018, 2018, 2018, 2018, 2018, 2018, 2018, 2018, 2018, 2018, 2018, 2018, 2018, 2018, 2018, 2018, 2018, 2018, 2018, 2018, 2018, 2018, 2018, 2018, 2018, 2018, 2018, 2018, 2018, 2018, 2018, 2019, 2019, 2019, 2019, 2019, 2019, 2020, 2020, 2020, 2020, 2020, 2020, 2020, 2020, 2020, 2020, 2020, 2020, 2020, 2020, 2020, 2020, 2020, 2020, 2020, 2020, 2020, 2020, 2020, 2020, 2020, 2020, 2020, 2020, 2020, 2020, 2020, 2020, 2020, 2020, 2020, 2020, 2020, 2021, 2021, 2021, 2021]",8.417391304347825,0.003716486552095747,Low Gender Representation,0.4043478260869565,4
55059,21,113,134,"[2010, 2010, 2010, 2010, 2010, 2010, 2010, 2010, 2010, 2010, 2010, 2010, 2010, 2010, 2010, 2010, 2010, 2010, 2010, 2010, 2010, 2010, 2010, 2012, 2012, 2012, 2012, 2012, 2012, 2012, 2012, 2012, 2012, 2012, 2012, 2012, 2012, 2012, 2012, 2012, 2012, 2012, 2012, 2012, 2012, 2012, 2014, 2014, 2014, 2014, 2014, 2014, 2014, 2014, 2014, 2014, 2014, 2014, 2014, 2014, 2014, 2014, 2014, 2014, 2014, 2014, 2014, 2014, 2014, 2016, 2016, 2016, 2016, 2016, 2016, 2016, 2016, 2016, 2016, 2016, 2016, 2016, 2016, 2016, 2016, 2016, 2016, 2016, 2016, 2016, 2016, 2016, 2018, 2018, 2018, 2018, 2018, 2018, 2018, 2018, 2018, 2018, 2018, 2018, 2018, 2018, 2018, 2018, 2018, 2018, 2018, 2018, 2018, 2018, 2018, 2020, 2020, 2020, 2020, 2020, 2020, 2020, 2020, 2020, 2020, 2020, 2020, 2020, 2020, 2020, 2020, 2020, 2020, 2020, 2020, 2020, 2020, 2020]",63.16417910447761,1.901755826128096e-15,Low Gender Representation,0.15671641791044777,2
55079,29,71,100,"[2008, 2008, 2008, 2008, 2008, 2008, 2008, 2008, 2008, 2008, 2008, 2008, 2008, 2008, 2008, 2008, 2008, 2008, 2010, 2011, 2011, 2012, 2012, 2012, 2012, 2012, 2012, 2012, 2012, 2012, 2012, 2012, 2012, 2012, 2012, 2012, 2012, 2012, 2012, 2013, 2013, 2014, 2015, 2015, 2016, 2016, 2016, 2016, 2016, 2016, 2016, 2016, 2016, 2016, 2016, 2016, 2016, 2016, 2016, 2016, 2016, 2016, 2018, 2018, 2018, 2018, 2018, 2018, 2018, 2018, 2018, 2018, 2018, 2018, 2018, 2018, 2018, 2018, 2018, 2018, 2018, 2018, 2020, 2020, 2020, 2020, 2020, 2020, 2020, 2020, 2020, 2020, 2020, 2020, 2020, 2020, 2020, 2020, 2020, 2020, 2021]",17.64,2.6691498031812692e-05,Low Gender Representation,0.29,3
55087,20,51,71,"[2018, 2018, 2018, 2018, 2018, 2018, 2018, 2018, 2018, 2018, 2018, 2018, 2018, 2018, 2018, 2018, 2018, 2018, 2018, 2018, 2018, 2018, 2018, 2018, 2018, 2018, 2018, 2018, 2018, 2018, 2018, 2018, 2018, 2018, 2018, 2018, 2020, 2020, 2020, 2020, 2020, 2020, 2020, 2020, 2020, 2020, 2020, 2020, 2020, 2020, 2020, 2020, 2020, 2020, 2020, 2020, 2020, 2020, 2020, 2020, 2020, 2020, 2020, 2020, 2020, 2020, 2020, 2020, 2020, 2020, 2020]",13.535211267605634,0.00023412902607901562,Low Gender Representation,0.28169014084507044,3
55101,11,52,63,"[2016, 2016, 2016, 2016, 2016, 2016, 2016, 2016, 2016, 2016, 2016, 2016, 2016, 2016, 2016, 2016, 2016, 2016, 2016, 2016, 2016, 2018, 2018, 2018, 2018, 2018, 2018, 2018, 2018, 2018, 2018, 2018, 2018, 2018, 2018, 2018, 2018, 2018, 2018, 2018, 2018, 2018, 2020, 2020, 2020, 2020, 2020, 2020, 2020, 2020, 2020, 2020, 2020, 2020, 2020, 2020, 2020, 2020, 2020, 2020, 2020, 2020, 2020]",26.682539682539684,2.3977848378779924e-07,Low Gender Representation,0.1746031746031746,2
55105,24,60,84,"[2016, 2016, 2016, 2016, 2016, 2016, 2016, 2016, 2016, 2016, 2016, 2016, 2016, 2016, 2016, 2016, 2016, 2016, 2016, 2016, 2016, 2016, 2016, 2016, 2016, 2016, 2016, 2016, 2018, 2018, 2018, 2018, 2018, 2018, 2018, 2018, 2018, 2018, 2018, 2018, 2018, 2018, 2018, 2018, 2018, 2018, 2018, 2018, 2018, 2018, 2018, 2018, 2018, 2018, 2018, 2018, 2018, 2020, 2020, 2020, 2020, 2020, 2020, 2020, 2020, 2020, 2020, 2020, 2020, 2020, 2020, 2020, 2020, 2020, 2020, 2020, 2020, 2020, 2020, 2020, 2020, 2020, 2020, 2020, 2020]",15.428571428571429,8.56829801091046e-05,Low Gender Representation,0.2857142857142857,3
55133,39,135,174,"[2006, 2006, 2006, 2006, 2006, 2006, 2006, 2006, 2006, 2006, 2006, 2006, 2006, 2006, 2006, 2006, 2006, 2006, 2006, 2006, 2006, 2006, 2006, 2006, 2006, 2008, 2008, 2008, 2008, 2008, 2008, 2008, 2008, 2008, 2008, 2008, 2008, 2008, 2008, 2008, 2008, 2008, 2008, 2008, 2008, 2008, 2008, 2008, 2008, 2008, 2010, 2010, 2010, 2010, 2010, 2010, 2010, 2010, 2010, 2010, 2010, 2010, 2010, 2010, 2010, 2010, 2010, 2010, 2010, 2010, 2010, 2010, 2010, 2010, 2010, 2012, 2012, 2012, 2012, 2012, 2012, 2012, 2012, 2012, 2012, 2012, 2012, 2012, 2012, 2012, 2012, 2012, 2012, 2012, 2012, 2012, 2012, 2012, 2012, 2012, 2016, 2016, 2016, 2016, 2016, 2016, 2016, 2016, 2016, 2016, 2016, 2016, 2016, 2016, 2016, 2016, 2016, 2016, 2016, 2016, 2016, 2016, 2016, 2016, 2016, 2018, 2018, 2018, 2018, 2018, 2018, 2018, 2018, 2018, 2018, 2018, 2018, 2018, 2018, 2018, 2018, 2018, 2018, 2018, 2018, 2018, 2018, 2018, 2018, 2018, 2020, 2020, 2020, 2020, 2020, 2020, 2020, 2020, 2020, 2020, 2020, 2020, 2020, 2020, 2020, 2020, 2020, 2020, 2020, 2020, 2020, 2020, 2020, 2020, 2020]",52.96551724137931,3.3945568671599367e-13,Low Gender Representation,0.22413793103448276,2
55139,21,81,102,"[2016, 2016, 2016, 2016, 2016, 2016, 2016, 2016, 2016, 2016, 2016, 2016, 2016, 2016, 2016, 2016, 2016, 2016, 2016, 2016, 2016, 2016, 2016, 2016, 2016, 2016, 2016, 2016, 2016, 2016, 2016, 2016, 2016, 2018, 2018, 2018, 2018, 2018, 2018, 2018, 2018, 2018, 2018, 2018, 2018, 2018, 2018, 2018, 2018, 2018, 2018, 2018, 2018, 2018, 2018, 2018, 2018, 2018, 2018, 2018, 2018, 2018, 2018, 2018, 2018, 2018, 2018, 2020, 2020, 2020, 2020, 2020, 2020, 2020, 2020, 2020, 2020, 2020, 2020, 2020, 2020, 2020, 2020, 2020, 2020, 2020, 2020, 2020, 2020, 2020, 2020, 2020, 2020, 2020, 2020, 2020, 2020, 2020, 2020, 2020, 2020, 2020]",35.294117647058826,2.834869930488155e-09,Low Gender Representation,0.20588235294117646,2
